game_id,team_id,kicks,handballs,disposals,marks,tackles,hitouts,frees_for,frees_against,goals_kicked,behinds_kicked,behinds_rushed,scoring_shots,inside_50s,in50s_score,in50s_goal
1,1,176,123,299,54,16,10,0,0,17,11,0,28,0,,
1,2,173,86,259,61,17,14,0,0,17,7,2,26,0,,
2,3,195,99,294,51,27,28,0,0,12,7,3,22,0,,
2,4,204,122,326,66,33,16,0,0,11,12,1,24,0,,
3,5,181,69,250,69,36,22,0,0,17,11,1,29,0,,
3,6,166,120,286,59,24,14,0,0,16,6,1,23,0,,
4,7,174,90,264,59,17,18,0,0,15,7,0,22,0,,
4,8,206,123,329,77,29,25,0,0,23,14,1,38,0,,
5,9,164,111,275,50,36,17,0,0,13,16,5,34,0,,
5,10,164,81,245,69,25,18,0,0,12,14,3,29,0,,
6,11,226,136,362,95,28,22,0,0,22,13,5,40,0,,
6,12,183,123,306,64,24,19,0,0,13,5,1,19,0,,
7,13,221,110,331,89,23,24,0,0,26,17,1,44,0,,
7,14,161,73,234,54,29,18,0,0,16,11,2,29,0,,
8,15,189,116,305,58,21,20,0,0,21,12,4,37,0,,
8,7,209,127,336,62,20,6,0,0,10,12,1,23,0,,
9,8,157,106,263,60,38,11,0,0,8,13,3,24,0,,
9,13,187,141,328,76,24,24,0,0,17,14,2,33,0,,
10,6,185,109,294,60,35,11,0,0,17,10,0,27,0,,
10,3,188,105,293,53,25,24,0,0,14,13,2,29,0,,
11,2,218,137,355,76,27,13,0,0,20,11,3,34,0,,
11,9,168,137,305,47,31,17,0,0,11,6,0,17,0,,
12,4,178,76,254,70,33,46,0,0,14,10,3,27,0,,
12,11,167,120,287,50,18,28,0,0,11,9,3,23,0,,
13,14,212,122,334,83,21,25,0,0,22,16,4,42,0,,
13,1,176,92,268,54,31,13,0,0,8,15,1,24,0,,
14,5,197,99,296,81,38,21,0,0,14,15,1,30,0,,
14,12,172,97,269,63,29,19,0,0,9,11,1,21,0,,
15,15,206,107,313,74,21,18,0,0,25,21,2,48,0,,
15,8,172,109,281,66,25,2,0,0,6,8,2,16,0,,
16,2,163,95,258,56,14,11,0,0,5,9,0,14,0,,
16,4,222,115,337,95,35,18,0,0,20,14,1,35,0,,
17,7,215,89,304,90,32,20,0,0,16,11,1,28,0,,
17,3,186,106,292,65,25,13,0,0,14,10,0,24,0,,
18,6,202,106,308,71,40,16,0,0,17,9,0,26,0,,
18,9,162,147,309,59,17,13,0,0,12,3,3,18,0,,
19,5,170,82,252,54,33,31,0,0,14,10,1,25,0,,
19,1,199,83,282,57,30,14,0,0,12,20,2,34,0,,
20,12,204,130,334,69,34,15,0,0,14,10,5,29,0,,
20,14,190,96,286,63,32,18,0,0,10,9,1,20,0,,
21,10,170,120,290,50,19,11,0,0,21,8,1,30,0,,
21,11,187,141,328,62,29,19,0,0,24,9,1,34,0,,
22,10,189,105,294,61,29,20,0,0,11,16,4,31,0,,
22,2,177,116,293,69,20,11,0,0,10,9,3,22,0,,
23,1,198,97,295,66,26,17,0,0,14,15,0,29,0,,
23,15,168,96,264,54,17,16,0,0,17,10,0,27,0,,
24,3,161,110,271,54,37,15,0,0,9,11,1,21,0,,
24,13,204,135,339,70,35,16,0,0,12,10,2,24,0,,
25,4,217,100,317,78,17,35,0,0,18,18,3,39,0,,
25,6,151,98,249,56,27,21,0,0,8,5,0,13,0,,
26,8,175,89,264,65,25,12,0,0,11,6,1,18,0,,
26,12,229,161,390,87,17,25,0,0,24,16,0,40,0,,
27,9,176,118,294,60,28,14,0,0,22,16,3,41,0,,
27,7,151,97,248,43,37,20,0,0,15,8,0,23,0,,
28,11,193,159,352,56,14,12,0,0,15,11,3,29,0,,
28,14,204,101,305,78,11,31,0,0,11,8,3,22,0,,
29,13,230,147,377,90,32,25,0,0,17,12,3,32,0,,
29,9,165,120,285,59,35,8,0,0,4,4,2,10,0,,
30,14,204,137,341,81,26,26,0,0,17,16,2,35,0,,
30,15,174,92,266,38,26,10,0,0,15,12,3,30,0,,
31,6,185,99,284,76,32,20,0,0,20,16,1,37,0,,
31,10,164,116,280,63,22,6,0,0,20,6,3,29,0,,
32,3,178,111,289,57,37,30,0,0,14,12,2,28,0,,
32,5,150,95,245,57,29,23,0,0,14,8,2,24,0,,
33,11,183,130,313,61,21,32,0,0,13,12,3,28,0,,
33,1,197,106,303,66,15,23,0,0,17,6,2,25,0,,
34,7,172,98,270,64,33,17,0,0,10,10,0,20,0,,
34,2,187,118,305,64,26,12,0,0,15,18,4,37,0,,
35,4,167,76,243,65,24,36,0,0,8,10,0,18,0,,
35,8,211,109,320,60,23,30,0,0,19,12,3,34,0,,
36,15,167,97,264,45,20,24,0,0,13,8,0,21,0,,
36,4,192,123,315,61,20,9,0,0,18,12,3,33,0,,
37,12,210,133,343,69,19,25,0,0,20,10,4,34,0,,
37,10,166,96,262,52,28,5,0,0,11,6,2,19,0,,
38,9,183,132,315,71,23,23,0,0,17,7,1,25,0,,
38,11,186,148,334,51,46,30,0,0,18,9,4,31,0,,
39,13,191,116,307,81,29,19,0,0,9,6,0,15,0,,
39,5,161,113,274,67,38,25,0,0,8,4,3,15,0,,
40,13,184,135,319,69,19,19,0,0,8,5,5,18,0,,
40,15,194,82,276,59,37,18,0,0,13,10,2,25,0,,
41,8,226,64,290,111,30,7,0,0,12,13,3,28,0,,
41,3,215,124,339,85,19,17,0,0,11,7,2,20,0,,
42,2,201,139,340,77,19,14,0,0,20,8,5,33,0,,
42,6,183,124,307,69,42,12,0,0,13,12,2,27,0,,
43,10,178,156,334,41,45,15,0,0,17,7,0,24,0,,
43,7,191,95,286,61,30,27,0,0,16,13,1,30,0,,
44,4,210,79,289,86,31,21,0,0,16,15,4,35,0,,
44,12,156,118,274,47,16,34,0,0,6,11,2,19,0,,
45,1,199,119,318,74,28,16,0,0,12,11,3,26,0,,
45,9,160,147,307,49,23,13,0,0,7,6,1,14,0,,
46,14,190,125,315,80,34,18,0,0,18,15,1,34,0,,
46,5,185,106,291,79,34,20,0,0,13,11,7,31,0,,
47,2,174,115,289,52,23,12,0,0,16,9,2,27,0,,
47,12,191,145,336,64,28,18,0,0,20,14,1,35,0,,
48,6,185,137,322,71,32,13,0,0,13,11,1,25,0,,
48,15,207,119,326,59,23,14,0,0,17,12,5,34,0,,
49,5,193,149,342,91,34,19,0,0,19,11,2,32,0,,
49,7,175,115,290,57,24,17,0,0,11,11,1,23,0,,
50,8,238,135,373,93,30,9,0,0,25,13,3,41,0,,
50,9,161,118,279,44,11,23,0,0,10,7,0,17,0,,
51,10,167,102,269,59,37,18,0,0,9,14,3,26,0,,
51,14,199,108,307,93,28,17,0,0,25,15,0,40,0,,
52,13,164,141,305,58,38,29,0,0,13,11,2,26,0,,
52,1,191,89,280,55,40,14,0,0,14,9,1,24,0,,
53,3,222,109,331,97,28,13,0,0,20,9,2,31,0,,
53,11,173,109,282,63,34,24,0,0,13,9,1,23,0,,
54,15,196,92,288,72,19,22,0,0,17,19,0,36,0,,
54,5,173,136,309,56,35,20,0,0,13,8,2,23,0,,
55,13,169,88,257,47,28,20,0,0,14,10,3,27,0,,
55,10,163,110,273,51,26,16,0,0,16,7,3,26,0,,
56,14,195,180,375,71,25,26,0,0,21,13,3,37,0,,
56,2,163,109,272,55,29,15,0,0,11,9,3,23,0,,
57,1,173,76,249,45,35,15,0,0,7,10,0,17,0,,
57,4,143,68,211,42,47,28,0,0,12,10,1,23,0,,
58,3,201,104,305,75,23,12,0,0,9,9,0,18,0,,
58,12,182,160,342,64,43,20,0,0,7,18,2,27,0,,
59,11,162,141,303,81,24,35,0,0,7,6,0,13,0,,
59,8,218,116,334,84,44,31,0,0,22,11,2,35,0,,
60,7,187,115,302,75,45,28,0,0,11,8,1,20,0,,
60,6,178,94,272,69,19,13,0,0,8,11,3,22,0,,
61,4,191,91,282,77,33,31,0,0,14,14,3,31,0,,
61,10,179,76,255,64,22,35,0,0,10,13,2,25,0,,
62,3,206,130,336,78,30,19,0,0,16,15,1,32,0,,
62,14,171,122,293,94,29,28,0,0,15,9,2,26,0,,
63,5,176,120,296,89,37,22,0,0,16,10,4,30,0,,
63,8,161,69,230,66,25,15,0,0,10,10,4,24,0,,
64,12,193,94,287,66,23,27,0,0,16,11,2,29,0,,
64,1,194,72,266,79,33,17,0,0,13,16,3,32,0,,
65,7,162,102,264,55,34,17,0,0,4,8,0,12,0,,
65,13,211,115,326,95,14,19,0,0,15,15,1,31,0,,
66,9,206,128,334,97,30,17,0,0,17,15,3,35,0,,
66,15,172,104,276,52,24,14,0,0,12,19,2,33,0,,
67,11,227,154,381,106,15,33,0,0,15,11,2,28,0,,
67,6,197,127,324,78,13,13,0,0,9,7,3,19,0,,
68,14,192,117,309,75,18,19,0,0,15,9,2,26,0,,
68,9,190,105,295,74,39,28,0,0,19,9,3,31,0,,
69,5,184,111,295,76,40,25,0,0,13,12,0,25,0,,
69,11,161,117,278,58,25,18,0,0,8,14,5,27,0,,
70,3,215,141,356,83,29,17,0,0,24,7,3,34,0,,
70,2,155,101,256,52,27,19,0,0,17,5,1,23,0,,
71,12,174,167,341,77,32,23,0,0,20,14,1,35,0,,
71,6,173,125,298,81,21,16,0,0,12,7,1,20,0,,
72,13,179,93,272,60,26,13,0,0,11,7,1,19,0,,
72,4,197,116,313,74,38,21,0,0,18,9,1,28,0,,
73,10,210,136,346,88,17,11,0,0,16,8,2,26,0,,
73,15,186,113,299,66,20,24,0,0,19,9,3,31,0,,
74,8,206,137,343,94,25,15,0,0,20,4,1,25,0,,
74,1,189,90,279,63,29,16,0,0,8,11,2,21,0,,
75,14,179,112,291,61,38,16,0,0,17,9,2,28,0,,
75,7,201,96,297,64,51,19,0,0,16,13,1,30,0,,
76,13,184,140,324,67,31,18,0,0,13,13,3,29,0,,
76,12,167,131,298,61,36,19,0,0,18,11,2,31,0,,
77,1,194,98,292,75,36,18,0,0,13,10,4,27,0,,
77,3,190,115,305,92,26,21,0,0,9,10,0,19,0,,
78,15,215,100,315,60,29,24,0,0,21,21,2,44,0,,
78,11,177,132,309,74,23,14,0,0,10,8,1,19,0,,
79,10,167,120,287,76,35,8,0,0,13,3,2,18,0,,
79,8,198,100,298,66,38,15,0,0,21,13,2,36,0,,
80,4,196,97,293,70,16,35,0,0,11,6,6,23,0,,
80,9,163,115,278,50,25,30,0,0,10,7,2,19,0,,
81,2,181,103,284,58,24,15,0,0,14,13,5,32,0,,
81,5,165,103,268,63,30,29,0,0,4,10,2,16,0,,
82,12,182,156,338,43,56,23,0,0,22,12,1,35,0,,
82,7,154,93,247,35,29,13,0,0,10,3,2,15,0,,
83,2,183,100,283,44,25,16,0,0,9,14,4,27,0,,
83,15,165,84,249,51,21,13,0,0,10,4,3,17,0,,
84,8,187,162,349,68,39,18,0,0,7,9,2,18,0,,
84,6,188,131,319,68,32,18,0,0,10,5,1,16,0,,
85,1,223,105,328,88,26,21,0,0,20,13,1,34,0,,
85,10,161,100,261,49,34,10,0,0,9,6,0,15,0,,
86,5,184,122,306,75,33,27,0,0,18,12,1,31,0,,
86,4,181,76,257,54,29,22,0,0,12,8,4,24,0,,
87,9,202,97,299,94,30,12,0,0,17,12,0,29,0,,
87,3,168,130,298,55,28,14,0,0,11,14,1,26,0,,
88,11,165,115,280,43,37,40,0,0,11,11,6,28,0,,
88,13,157,98,255,60,18,20,0,0,12,5,1,18,0,,
89,15,178,71,249,43,21,19,0,0,13,10,0,23,0,,
89,12,197,143,340,70,31,18,0,0,15,15,1,31,0,,
90,13,180,111,291,66,32,27,0,0,9,7,1,17,0,,
90,2,154,72,226,36,31,20,0,0,11,8,4,23,0,,
91,1,228,120,348,64,37,19,0,0,21,15,3,39,0,,
91,6,159,78,237,58,31,13,0,0,6,3,1,10,0,,
93,14,189,101,290,38,32,31,0,0,10,14,1,25,0,,
93,4,205,73,278,48,43,21,0,0,14,7,2,23,0,,
94,3,203,121,324,91,28,22,0,0,19,15,0,34,0,,
94,10,170,75,245,69,20,13,0,0,14,8,3,25,0,,
95,9,208,111,319,75,30,18,0,0,17,14,5,36,0,,
95,5,153,103,256,61,21,17,0,0,11,6,5,22,0,,
96,4,221,83,304,73,20,20,0,0,19,11,3,33,0,,
96,7,188,114,302,68,26,22,0,0,7,7,0,14,0,,
97,6,151,77,228,65,36,13,0,0,9,9,2,20,0,,
97,13,185,134,319,65,27,18,0,0,16,14,1,31,0,,
98,8,212,117,329,102,42,22,0,0,16,18,1,35,0,,
98,14,170,100,270,57,25,15,0,0,11,11,2,24,0,,
99,15,174,88,262,67,17,12,0,0,11,17,2,30,0,,
99,3,191,125,316,82,31,29,0,0,14,7,1,22,0,,
100,12,209,149,358,75,34,14,0,0,22,11,1,34,0,,
100,9,162,138,300,51,25,13,0,0,6,8,2,16,0,,
101,11,171,118,289,55,39,37,0,0,12,10,1,23,0,,
101,2,167,110,277,56,27,31,0,0,13,11,1,25,0,,
102,10,181,94,275,61,31,15,0,0,10,10,3,23,0,,
102,5,176,102,278,80,39,16,0,0,13,13,2,28,0,,
103,8,230,102,332,93,43,20,0,0,21,13,3,37,0,,
103,7,185,134,319,57,23,16,0,0,11,11,1,23,0,,
104,14,177,77,254,56,35,27,0,0,22,12,1,35,0,,
104,13,167,111,278,54,40,21,0,0,17,11,2,30,0,,
105,2,164,81,245,55,27,16,0,0,14,8,5,27,0,,
105,1,195,116,311,56,32,19,0,0,12,21,1,34,0,,
106,6,168,122,290,76,33,6,0,0,11,12,2,25,0,,
106,5,173,153,326,59,32,21,0,0,19,11,4,34,0,,
107,4,189,97,286,55,35,17,0,0,11,11,3,25,0,,
107,3,177,101,278,51,27,40,0,0,5,12,2,19,0,,
108,10,172,124,296,65,33,13,0,0,15,12,8,35,0,,
108,9,181,121,302,61,23,15,0,0,21,9,0,30,0,,
109,12,193,137,330,73,32,13,0,0,20,16,0,36,0,,
109,11,169,96,265,60,34,11,0,0,10,15,1,26,0,,
110,1,208,97,305,77,36,19,0,0,17,11,0,28,0,,
110,14,165,78,243,54,37,24,0,0,13,6,1,20,0,,
111,7,186,127,313,56,24,19,0,0,8,6,1,15,0,,
111,15,200,97,297,63,22,18,0,0,17,11,3,31,0,,
112,5,174,127,301,81,33,9,0,0,7,9,3,19,0,,
112,12,200,113,313,81,30,13,0,0,14,11,2,27,0,,
113,13,209,133,342,85,31,17,0,0,17,6,4,27,0,,
113,8,170,106,276,63,40,19,0,0,11,5,3,19,0,,
114,3,197,137,334,90,23,28,0,0,24,9,0,33,0,,
114,6,186,130,316,81,28,8,0,0,12,14,3,29,0,,
115,9,174,139,313,48,37,20,0,0,12,9,3,24,0,,
115,2,167,77,244,48,38,16,0,0,15,7,1,23,0,,
116,11,203,96,299,71,27,40,0,0,12,7,3,22,0,,
116,4,202,83,285,77,16,18,0,0,11,10,2,23,0,,
117,11,216,115,331,91,55,32,0,0,10,11,4,25,0,,
117,10,197,120,317,67,39,34,0,0,13,8,1,22,0,,
118,8,185,101,286,72,32,12,0,0,9,3,2,14,0,,
118,15,196,111,307,66,14,15,0,0,15,7,2,24,0,,
119,3,185,147,332,64,33,19,0,0,15,9,1,25,0,,
119,7,187,100,287,78,29,20,0,0,18,2,0,20,0,,
120,1,195,77,272,73,29,32,0,0,13,8,1,22,0,,
120,5,169,102,271,61,45,16,0,0,7,12,1,20,0,,
121,9,156,102,258,61,24,10,0,0,8,16,1,25,0,,
121,6,176,92,268,76,27,10,0,0,7,11,5,23,0,,
122,4,225,105,330,99,33,44,0,0,14,12,5,31,0,,
122,2,153,79,232,49,24,21,0,0,7,9,2,18,0,,
123,14,186,99,285,64,30,11,0,0,13,10,2,25,0,,
123,12,171,102,273,50,33,20,0,0,8,5,1,14,0,,
124,15,203,97,300,59,19,19,0,0,15,10,2,27,0,,
124,1,190,85,275,60,29,23,0,0,12,7,3,22,0,,
125,12,172,92,264,59,37,15,0,0,15,11,3,29,0,,
125,8,168,102,270,57,36,8,0,0,9,12,6,27,0,,
126,13,214,122,336,92,16,19,0,0,21,8,1,30,0,,
126,3,168,96,264,56,43,27,0,0,8,7,3,18,0,,
127,7,203,100,303,83,45,18,0,0,5,15,0,20,0,,
127,9,171,103,274,63,20,12,0,0,8,5,2,15,0,,
128,2,184,96,280,51,22,18,0,0,14,9,2,25,0,,
128,10,185,83,268,70,23,20,0,0,9,7,1,17,0,,
129,6,183,84,267,43,44,22,0,0,3,7,1,11,0,,
129,4,222,73,295,52,31,11,0,0,13,12,2,27,0,,
130,14,220,103,323,57,42,22,0,0,13,11,2,26,0,,
130,11,187,111,298,58,37,18,0,0,5,7,1,13,0,,
131,5,168,138,306,62,31,19,0,0,19,17,3,39,0,,
131,3,154,93,247,70,26,28,0,0,17,3,1,21,0,,
132,2,174,100,274,58,25,19,0,0,12,18,3,33,0,,
132,7,148,107,255,40,37,14,0,0,9,6,1,16,0,,
133,8,209,115,324,77,43,12,0,0,15,8,2,25,0,,
133,4,180,85,265,42,35,16,0,0,7,11,1,19,0,,
134,14,188,112,300,57,32,18,0,0,10,15,3,28,0,,
134,15,166,83,249,47,21,21,0,0,11,9,2,22,0,,
135,9,152,68,220,41,28,18,0,0,12,9,3,24,0,,
135,13,189,93,282,68,29,17,0,0,14,13,2,29,0,,
136,10,175,129,304,64,19,9,0,0,9,8,4,21,0,,
136,6,204,133,337,82,35,14,0,0,13,12,4,29,0,,
137,1,221,103,324,80,39,19,0,0,17,14,2,33,0,,
137,11,157,111,268,51,32,26,0,0,4,6,4,14,0,,
138,4,204,90,294,72,36,16,0,0,10,8,5,23,0,,
138,15,183,73,256,57,21,33,0,0,9,7,3,19,0,,
139,7,196,121,317,89,27,21,0,0,10,10,2,22,0,,
139,1,208,111,319,71,34,18,0,0,17,13,2,32,0,,
140,13,174,97,271,63,23,12,0,0,9,10,0,19,0,,
140,5,157,127,284,53,32,19,0,0,13,10,4,27,0,,
141,14,186,137,323,76,27,18,0,0,13,19,3,35,0,,
141,6,189,93,282,82,41,14,0,0,8,9,2,19,0,,
142,11,176,116,292,78,41,35,0,0,13,8,3,24,0,,
142,9,192,113,305,68,27,20,0,0,12,8,6,26,0,,
143,2,180,81,261,49,22,23,0,0,11,16,7,34,0,,
143,8,196,98,294,104,30,11,0,0,18,9,0,27,0,,
144,10,195,122,317,69,32,9,0,0,9,13,3,25,0,,
144,12,175,116,291,70,26,21,0,0,8,13,1,22,0,,
145,15,164,111,275,44,35,20,0,0,12,8,3,23,0,,
145,13,203,125,328,70,31,23,0,0,15,11,2,28,0,,
146,7,225,118,343,105,34,21,0,0,17,10,2,29,0,,
146,10,171,115,286,57,22,14,0,0,11,13,2,26,0,,
147,6,163,127,290,70,25,12,0,0,10,9,0,19,0,,
147,2,174,98,272,64,20,18,0,0,19,12,3,34,0,,
148,5,187,123,310,70,29,21,0,0,15,16,1,32,0,,
148,14,182,68,250,70,23,16,0,0,16,8,0,24,0,,
149,3,192,142,334,76,16,20,0,0,20,12,4,36,0,,
149,8,179,81,260,85,21,17,0,0,12,9,3,24,0,,
150,12,192,142,334,69,33,29,0,0,19,11,1,31,0,,
150,4,170,89,259,53,29,11,0,0,8,10,4,22,0,,
151,9,173,103,276,63,24,28,0,0,13,8,2,23,0,,
151,1,179,57,236,49,40,24,0,0,14,11,3,28,0,,
152,15,201,135,336,84,20,22,0,0,25,8,2,35,0,,
152,6,180,113,293,74,30,9,0,0,10,9,5,24,0,,
153,14,213,138,351,82,27,25,0,0,16,12,3,31,0,,
153,10,189,129,318,74,28,12,0,0,15,9,0,24,0,,
154,1,200,66,266,62,32,23,0,0,16,14,1,31,0,,
154,13,149,80,229,50,29,16,0,0,11,4,1,16,0,,
155,12,197,175,372,64,37,18,0,0,25,11,0,36,0,,
155,2,144,66,210,40,19,5,0,0,6,11,1,18,0,,
156,7,190,123,313,55,22,24,0,0,14,6,0,20,0,,
156,5,171,111,282,58,32,15,0,0,13,9,1,23,0,,
157,9,172,104,276,45,17,17,0,0,13,11,2,26,0,,
157,8,211,88,299,101,30,16,0,0,15,10,2,27,0,,
158,11,206,141,347,71,31,31,0,0,17,10,3,30,0,,
158,3,204,141,345,91,28,21,0,0,8,7,3,18,0,,
159,5,182,112,294,69,28,20,0,0,8,9,5,22,0,,
159,15,197,112,309,52,23,21,0,0,19,10,2,31,0,,
160,6,170,112,282,48,44,11,0,0,15,9,3,27,0,,
160,7,197,143,340,54,39,22,0,0,21,11,3,35,0,,
161,3,193,113,306,73,27,15,0,0,12,8,0,20,0,,
161,12,176,117,293,58,30,29,0,0,9,8,0,17,0,,
162,8,221,116,337,92,34,15,0,0,9,9,3,21,0,,
162,11,198,162,360,73,20,12,0,0,6,11,0,17,0,,
163,14,203,128,331,72,32,24,0,0,27,6,3,36,0,,
163,2,178,76,254,47,26,15,0,0,13,12,5,30,0,,
164,10,171,115,286,58,39,17,0,0,18,13,0,31,0,,
164,13,180,127,307,56,21,20,0,0,27,4,1,32,0,,
165,4,202,103,305,83,17,43,0,0,17,12,3,32,0,,
165,1,186,51,237,56,13,22,0,0,6,9,1,16,0,,
175,15,200,85,285,59,16,11,0,0,11,8,5,24,0,,
175,11,199,124,323,57,20,15,0,0,10,15,1,26,0,,
177,2,184,88,272,65,25,17,0,0,12,14,4,30,0,,
177,16,164,103,267,58,25,13,0,0,12,8,5,25,0,,
178,6,184,119,303,69,33,12,0,0,6,2,0,8,0,,
178,3,227,173,400,92,17,16,0,0,16,16,0,32,0,,
179,8,214,98,312,82,33,19,0,0,20,5,2,27,0,,
179,9,177,123,300,45,21,16,0,0,11,4,0,15,0,,
180,1,203,91,294,58,41,20,0,0,15,8,4,27,0,,
180,10,171,111,282,69,20,12,0,0,12,13,0,25,0,,
181,4,202,120,322,74,39,20,0,0,18,13,0,31,0,,
181,7,163,76,239,57,27,20,0,0,11,8,1,20,0,,
182,5,174,102,276,59,33,14,0,0,9,9,3,21,0,,
182,12,190,122,312,71,23,24,0,0,14,6,5,25,0,,
183,16,169,73,242,65,37,24,0,0,11,13,3,27,0,,
183,3,219,100,319,94,25,25,0,0,12,17,2,31,0,,
184,13,178,116,294,59,17,26,0,0,12,12,3,27,0,,
184,15,175,70,245,46,20,15,0,0,16,10,0,26,0,,
185,12,222,168,390,103,28,16,0,0,18,13,4,35,0,,
185,6,181,127,308,81,33,6,0,0,8,7,1,16,0,,
186,8,172,80,252,63,37,29,0,0,10,10,1,21,0,,
186,1,186,67,253,61,30,29,0,0,14,7,4,25,0,,
187,5,179,105,284,38,48,20,0,0,11,6,4,21,0,,
187,4,179,73,252,43,34,16,0,0,11,11,3,25,0,,
188,7,194,106,300,68,27,18,0,0,9,13,2,24,0,,
188,2,186,67,253,53,20,16,0,0,14,10,1,25,0,,
189,10,171,105,276,61,28,12,0,0,10,14,1,25,0,,
189,14,170,88,258,70,25,20,0,0,11,11,3,25,0,,
190,9,196,121,317,75,18,15,0,0,18,16,2,36,0,,
190,11,175,115,290,47,24,12,0,0,14,10,5,29,0,,
191,6,203,139,342,77,36,14,0,0,11,12,0,23,0,,
191,16,178,90,268,76,29,15,0,0,18,8,5,31,0,,
192,4,222,88,310,98,26,17,0,0,12,17,2,31,0,,
192,15,166,64,230,38,26,24,0,0,5,10,3,18,0,,
193,14,168,91,259,53,28,29,0,0,18,12,2,32,0,,
193,5,165,84,249,53,26,21,0,0,14,9,2,25,0,,
194,12,233,148,381,91,32,25,0,0,23,19,1,43,0,,
194,1,149,78,227,38,29,11,0,0,8,12,0,20,0,,
195,8,187,70,257,47,39,20,0,0,5,3,1,9,0,,
195,2,199,85,284,40,29,19,0,0,4,9,7,20,0,,
196,9,189,108,297,66,41,25,0,0,15,13,1,29,0,,
196,10,189,127,316,65,24,24,0,0,14,14,1,29,0,,
197,11,197,137,334,62,37,24,0,0,13,13,1,27,0,,
197,7,190,87,277,63,23,35,0,0,3,7,1,11,0,,
198,3,170,111,281,56,36,18,0,0,14,11,3,28,0,,
198,13,169,61,230,65,24,19,0,0,12,7,3,22,0,,
199,16,201,106,307,82,28,14,0,0,12,14,8,34,0,,
199,14,184,97,281,70,21,20,0,0,10,14,1,25,0,,
200,7,199,135,334,76,32,20,0,0,10,10,0,20,0,,
200,8,210,134,344,96,37,17,0,0,16,9,1,26,0,,
166,15,237,101,338,81,21,17,0,0,15,20,4,39,0,,
166,8,219,110,329,79,33,19,0,0,13,12,1,26,0,,
167,14,172,94,266,62,34,27,0,0,15,14,2,31,0,,
167,1,181,76,257,59,34,16,0,0,15,10,1,26,0,,
168,13,209,115,324,81,35,27,0,0,18,13,2,33,0,,
168,12,170,103,273,61,30,13,0,0,14,9,3,26,0,,
169,4,180,79,259,58,17,31,0,0,11,12,4,27,0,,
169,5,163,92,255,46,22,25,0,0,12,5,3,20,0,,
170,14,206,130,336,89,27,20,0,0,15,15,0,30,0,,
170,12,175,107,282,69,29,24,0,0,10,10,2,22,0,,
171,13,203,127,330,75,31,37,0,0,21,15,3,39,0,,
171,1,164,56,220,50,33,19,0,0,9,10,1,20,0,,
172,4,204,107,311,65,22,26,0,0,16,17,4,37,0,,
172,13,158,124,282,50,24,29,0,0,8,2,2,12,0,,
173,14,198,111,309,67,29,12,0,0,16,10,3,29,0,,
173,15,186,96,282,53,18,25,0,0,14,17,2,33,0,,
174,4,204,95,299,80,33,9,0,0,20,15,8,43,0,,
174,14,156,88,244,47,31,32,0,0,8,14,1,23,0,,
201,10,178,109,287,74,25,13,0,0,17,13,1,31,0,,
201,6,193,112,305,69,32,11,0,0,12,10,2,24,0,,
202,9,169,124,293,55,26,13,0,0,12,8,2,22,0,,
202,12,201,125,326,85,21,15,0,0,18,10,1,29,0,,
203,11,204,129,333,68,38,43,0,0,7,12,2,21,0,,
203,4,205,92,297,79,35,27,0,0,6,8,2,16,0,,
204,1,182,97,279,65,50,18,0,0,16,7,0,23,0,,
204,13,188,112,300,76,15,24,0,0,12,7,1,20,0,,
205,2,232,115,347,72,43,30,0,0,21,7,1,29,0,,
205,15,186,86,272,44,21,16,0,0,13,7,0,20,0,,
207,1,185,110,295,52,38,22,0,0,14,13,1,28,0,,
207,16,201,88,289,96,31,20,0,0,14,12,0,26,0,,
208,4,185,92,277,67,33,20,0,0,13,10,2,25,0,,
208,13,198,90,288,81,20,31,0,0,11,6,2,19,0,,
209,14,196,159,355,95,17,18,0,0,28,12,1,41,0,,
209,6,179,134,313,70,38,18,0,0,13,13,1,27,0,,
210,2,188,88,276,42,25,19,0,0,17,5,9,31,0,,
210,9,161,122,283,68,21,18,0,0,14,5,7,26,0,,
211,8,216,98,314,64,36,13,0,0,14,12,0,26,0,,
211,5,157,82,239,28,34,37,0,0,4,11,2,17,0,,
212,15,181,84,265,42,20,10,0,0,7,4,4,15,0,,
212,12,213,89,302,53,27,19,0,0,12,7,5,24,0,,
213,10,191,131,322,61,41,16,0,0,20,23,1,44,0,,
213,11,165,99,264,48,20,22,0,0,12,15,0,27,0,,
214,3,228,126,354,51,27,21,0,0,24,7,3,34,0,,
214,7,190,109,299,65,30,14,0,0,5,5,3,13,0,,
215,11,168,90,258,54,37,27,0,0,11,8,3,22,0,,
215,13,175,79,254,61,27,25,0,0,10,8,1,19,0,,
216,1,177,108,285,59,32,14,0,0,8,11,3,22,0,,
216,14,224,112,336,91,38,25,0,0,22,15,3,40,0,,
217,5,176,117,293,74,33,22,0,0,12,7,3,22,0,,
217,2,183,92,275,68,32,18,0,0,13,14,2,29,0,,
218,12,189,103,292,61,25,24,0,0,13,11,1,25,0,,
218,4,176,120,296,73,27,7,0,0,10,4,3,17,0,,
219,7,177,126,303,73,26,13,0,0,10,13,0,23,0,,
219,6,171,104,275,76,35,11,0,0,12,9,3,24,0,,
220,16,188,107,295,78,28,24,0,0,25,11,2,38,0,,
220,10,158,91,249,42,29,22,0,0,16,8,1,25,0,,
221,15,187,96,283,60,23,19,0,0,22,12,0,34,0,,
221,8,182,115,297,77,28,19,0,0,14,11,2,27,0,,
222,3,208,160,368,87,19,13,0,0,19,13,1,33,0,,
222,9,163,115,278,66,32,12,0,0,14,15,1,30,0,,
223,2,202,111,313,56,36,18,0,0,10,12,0,22,0,,
223,11,176,97,273,57,30,18,0,0,9,4,0,13,0,,
224,14,181,124,305,70,26,14,0,0,9,18,1,28,0,,
224,8,171,89,260,63,42,14,0,0,11,10,2,23,0,,
225,6,199,115,314,79,36,9,0,0,13,7,3,23,0,,
225,15,184,129,313,57,23,18,0,0,17,14,2,33,0,,
226,5,182,102,284,55,41,29,0,0,13,16,3,32,0,,
226,10,193,107,300,70,29,23,0,0,11,8,2,21,0,,
227,7,187,124,311,67,37,18,0,0,15,14,1,30,0,,
227,1,167,91,258,50,29,23,0,0,12,14,1,27,0,,
228,3,188,125,313,75,16,16,0,0,9,10,3,22,0,,
228,12,193,101,294,76,39,17,0,0,10,15,0,25,0,,
229,4,225,94,319,77,32,26,0,0,23,12,1,36,0,,
229,16,167,94,261,68,19,26,0,0,9,10,2,21,0,,
230,13,184,100,284,85,20,19,0,0,12,9,1,22,0,,
230,9,152,104,256,50,42,18,0,0,10,11,4,25,0,,
231,10,194,126,320,87,14,10,0,0,21,5,1,27,0,,
231,12,165,76,241,68,24,27,0,0,8,11,1,20,0,,
232,8,138,81,219,56,37,16,0,0,7,6,2,15,0,,
232,13,210,120,330,80,29,22,0,0,17,10,0,27,0,,
233,1,201,92,293,78,31,25,0,0,13,6,0,19,0,,
233,15,172,118,290,52,20,16,0,0,15,13,2,30,0,,
234,5,180,107,287,53,31,23,0,0,20,11,0,31,0,,
234,16,176,102,278,86,26,17,0,0,14,6,3,23,0,,
235,11,194,106,300,81,37,36,0,0,9,6,6,21,0,,
235,6,196,94,290,72,37,32,0,0,15,7,2,24,0,,
236,2,155,78,233,40,38,16,0,0,14,4,3,21,0,,
236,14,217,131,348,98,29,22,0,0,24,17,2,43,0,,
237,9,157,101,258,41,30,20,0,0,17,12,1,30,0,,
237,7,160,109,269,41,50,23,0,0,14,9,1,24,0,,
238,4,185,118,303,69,36,25,0,0,13,8,4,25,0,,
238,3,189,130,319,60,30,39,0,0,16,10,2,28,0,,
239,15,161,68,229,35,18,19,0,0,12,5,2,19,0,,
239,14,221,127,348,88,30,12,0,0,20,18,2,40,0,,
240,3,197,144,341,76,25,22,0,0,15,9,2,26,0,,
240,1,184,71,255,63,25,10,0,0,9,9,4,22,0,,
241,11,195,91,286,37,41,35,0,0,9,6,0,15,0,,
241,8,207,61,268,75,33,18,0,0,7,13,3,23,0,,
242,7,212,95,307,60,34,14,0,0,11,11,3,25,0,,
242,12,183,88,271,51,25,22,0,0,3,5,1,9,0,,
243,4,168,119,287,61,24,14,0,0,12,8,2,22,0,,
243,6,150,128,278,49,35,21,0,0,8,4,2,14,0,,
244,10,161,111,272,67,30,21,0,0,14,4,2,20,0,,
244,2,181,87,268,49,29,23,0,0,17,13,1,31,0,,
245,13,200,129,329,104,22,15,0,0,12,12,1,25,0,,
245,5,146,89,235,47,35,22,0,0,7,12,4,23,0,,
246,16,188,119,307,59,37,20,0,0,17,16,2,35,0,,
246,9,137,106,243,32,27,31,0,0,8,6,0,14,0,,
247,15,201,93,294,86,20,15,0,0,19,9,3,31,0,,
247,3,171,139,310,54,29,39,0,0,15,9,0,24,0,,
248,13,185,124,309,80,25,28,0,0,15,11,1,27,0,,
248,10,155,105,260,64,27,15,0,0,11,10,1,22,0,,
249,5,182,101,283,81,30,25,0,0,13,12,3,28,0,,
249,6,175,115,290,73,40,8,0,0,10,18,1,29,0,,
250,7,167,83,250,44,29,31,0,0,9,5,1,15,0,,
250,16,201,90,291,78,36,13,0,0,20,10,1,31,0,,
251,14,209,134,343,85,29,17,0,0,16,20,0,36,0,,
251,11,172,106,278,59,28,21,0,0,14,5,2,21,0,,
252,12,217,120,337,95,21,16,0,0,26,14,2,42,0,,
252,8,157,98,255,51,33,7,0,0,10,9,1,20,0,,
253,2,185,88,273,63,32,16,0,0,13,15,3,31,0,,
253,1,174,116,290,70,27,22,0,0,9,8,2,19,0,,
254,4,188,135,323,69,26,27,0,0,17,6,4,27,0,,
254,9,172,133,305,48,28,23,0,0,10,5,2,17,0,,
255,5,210,132,342,70,34,14,0,0,25,9,2,36,0,,
255,7,178,108,286,55,30,20,0,0,13,8,1,22,0,,
256,3,177,113,290,70,23,25,0,0,17,9,1,27,0,,
256,14,186,106,292,69,19,12,0,0,19,7,2,28,0,,
257,11,191,127,318,49,30,27,0,0,12,14,4,30,0,,
257,1,177,102,279,61,30,23,0,0,6,10,0,16,0,,
258,2,196,105,301,52,38,23,0,0,18,9,6,33,0,,
258,4,174,115,289,59,30,17,0,0,9,9,0,18,0,,
259,16,164,132,296,58,35,24,0,0,11,6,0,17,0,,
259,15,201,106,307,77,32,29,0,0,22,10,1,33,0,,
260,9,208,137,345,94,15,20,0,0,17,27,3,47,0,,
260,6,167,112,279,60,28,3,0,0,10,10,4,24,0,,
261,8,216,95,311,101,29,14,0,0,17,9,2,28,0,,
261,10,181,141,322,67,14,15,0,0,9,13,4,26,0,,
262,13,177,84,261,66,21,13,0,0,12,8,0,20,0,,
262,12,184,97,281,59,24,14,0,0,16,14,2,32,0,,
263,3,178,134,312,60,18,21,0,0,10,17,1,28,0,,
263,8,187,69,256,78,25,12,0,0,8,11,1,20,0,,
264,12,176,99,275,72,35,20,0,0,16,13,3,32,0,,
264,14,191,94,285,75,27,15,0,0,15,15,4,34,0,,
265,11,166,110,276,37,17,26,0,0,16,6,3,25,0,,
265,16,173,78,251,69,18,18,0,0,12,12,0,24,0,,
266,2,175,106,281,72,18,18,0,0,15,12,7,34,0,,
266,6,195,115,310,69,33,17,0,0,15,11,2,28,0,,
268,9,194,127,321,76,20,21,0,0,13,9,2,24,0,,
268,15,205,116,321,88,23,16,0,0,20,11,2,33,0,,
269,4,183,112,295,64,31,43,0,0,11,5,2,18,0,,
269,10,169,136,305,77,23,29,0,0,10,8,4,22,0,,
270,7,180,65,245,55,40,13,0,0,11,5,2,18,0,,
270,13,199,107,306,85,17,15,0,0,13,10,2,25,0,,
271,5,222,105,327,95,17,27,0,0,24,8,0,32,0,,
271,11,174,104,278,48,22,12,0,0,7,12,2,21,0,,
272,13,185,82,267,77,21,16,0,0,14,9,2,25,0,,
272,2,157,69,226,55,14,18,0,0,12,11,1,24,0,,
273,14,219,115,334,63,27,20,0,0,17,12,2,31,0,,
273,4,183,57,240,73,37,6,0,0,9,8,2,19,0,,
274,7,184,78,262,60,26,23,0,0,12,10,2,24,0,,
274,15,197,82,279,53,27,17,0,0,18,11,2,31,0,,
275,10,191,109,300,95,26,16,0,0,21,9,3,33,0,,
275,3,177,137,314,59,22,30,0,0,17,16,1,34,0,,
276,1,206,84,290,60,24,31,0,0,9,15,0,24,0,,
276,9,171,112,283,65,36,11,0,0,8,4,1,13,0,,
277,16,171,92,263,82,29,20,0,0,7,5,2,14,0,,
277,12,185,89,274,77,32,33,0,0,15,13,3,31,0,,
278,8,223,141,364,96,32,20,0,0,21,24,1,46,0,,
278,6,164,97,261,58,19,11,0,0,7,8,2,17,0,,
279,15,196,105,301,76,16,15,0,0,18,15,2,35,0,,
279,5,173,83,256,69,21,12,0,0,10,10,3,23,0,,
280,8,190,92,282,79,21,13,0,0,8,8,0,16,0,,
280,4,214,137,351,90,16,16,0,0,14,9,4,27,0,,
281,14,193,125,318,74,42,25,0,0,15,17,4,36,0,,
281,9,175,108,283,80,19,17,0,0,15,8,0,23,0,,
282,3,222,153,375,105,13,27,0,0,27,18,2,47,0,,
282,11,161,109,270,51,13,9,0,0,8,8,4,20,0,,
283,16,152,93,245,64,31,26,0,0,7,6,2,15,0,,
283,13,194,113,307,73,30,26,0,0,15,10,2,27,0,,
284,6,163,119,282,63,30,19,0,0,12,7,0,19,0,,
284,1,194,102,296,84,18,27,0,0,23,8,0,31,0,,
285,10,170,116,286,77,28,12,0,0,14,8,2,24,0,,
285,7,190,109,299,60,35,21,0,0,17,15,2,34,0,,
286,2,158,59,217,52,33,10,0,0,12,11,2,25,0,,
286,12,190,94,284,81,21,14,0,0,17,11,2,30,0,,
288,15,176,110,286,61,17,13,0,0,12,10,2,24,0,,
288,10,199,125,324,86,37,20,0,0,16,16,1,33,0,,
289,6,178,102,280,65,27,11,0,0,7,7,1,15,0,,
289,13,226,94,320,121,15,15,0,0,20,10,1,31,0,,
290,8,206,109,315,78,37,20,0,0,18,10,0,28,0,,
290,16,195,89,284,96,13,16,0,0,11,8,0,19,0,,
291,12,185,130,315,74,32,30,0,0,20,10,3,33,0,,
291,11,145,105,250,52,31,18,0,0,15,8,2,25,0,,
292,9,157,114,271,51,21,15,0,0,11,11,3,25,0,,
292,5,198,104,302,80,18,16,0,0,19,13,2,34,0,,
293,4,159,119,278,62,26,22,0,0,8,11,2,21,0,,
293,1,186,107,293,64,19,37,0,0,12,13,2,27,0,,
294,7,202,81,283,80,55,23,0,0,13,12,3,28,0,,
294,14,164,104,268,61,47,19,0,0,13,5,2,20,0,,
295,11,178,141,319,32,23,22,0,0,9,9,2,20,0,,
295,15,209,76,285,65,17,28,0,0,7,11,1,19,0,,
296,7,181,108,289,55,33,15,0,0,9,9,1,19,0,,
296,4,197,100,297,76,30,16,0,0,19,7,1,27,0,,
297,3,195,170,365,87,23,23,0,0,22,16,2,40,0,,
297,6,180,102,282,74,30,13,0,0,12,7,0,19,0,,
298,10,163,119,282,70,32,24,0,0,12,7,0,19,0,,
298,1,194,114,308,62,27,28,0,0,21,6,2,29,0,,
299,14,186,81,267,76,35,8,0,0,15,19,2,36,0,,
299,13,180,102,282,68,22,16,0,0,12,10,0,22,0,,
300,16,175,104,279,66,20,37,0,0,9,9,4,22,0,,
300,2,180,82,262,59,23,33,0,0,10,11,3,24,0,,
301,9,190,124,314,75,21,13,0,0,14,17,3,34,0,,
301,8,181,104,285,62,31,14,0,0,14,8,5,27,0,,
302,5,168,86,254,60,46,16,0,0,10,6,2,18,0,,
302,12,189,136,325,68,19,21,0,0,12,12,6,30,0,,
303,15,164,95,259,39,21,15,0,0,12,2,6,20,0,,
303,13,201,84,285,84,21,14,0,0,15,11,1,27,0,,
304,14,188,131,319,73,24,20,0,0,23,12,1,36,0,,
304,10,164,103,267,73,24,19,0,0,11,7,1,19,0,,
305,1,195,91,286,67,26,23,0,0,8,7,2,17,0,,
305,8,163,65,228,49,22,15,0,0,7,7,3,17,0,,
306,3,187,132,319,67,28,32,0,0,21,8,1,30,0,,
306,16,165,109,274,77,27,9,0,0,13,7,2,22,0,,
307,7,172,103,275,56,41,21,0,0,15,15,2,32,0,,
307,2,138,49,187,24,32,15,0,0,9,6,2,17,0,,
308,11,181,87,268,40,30,28,0,0,6,7,3,16,0,,
308,9,191,103,294,55,26,25,0,0,11,9,1,21,0,,
309,4,181,127,308,70,31,33,0,0,18,17,4,39,0,,
309,5,136,79,215,50,23,36,0,0,11,8,5,24,0,,
310,12,223,191,414,95,18,19,0,0,24,16,1,41,0,,
310,6,181,76,257,69,34,10,0,0,9,7,3,19,0,,
311,2,195,89,284,57,38,13,0,0,13,14,7,34,0,,
311,8,159,82,241,51,20,18,0,0,8,6,1,15,0,,
312,13,186,75,261,82,12,10,0,0,11,5,2,18,0,,
312,3,181,105,286,79,25,24,0,0,15,14,2,31,0,,
313,7,202,95,297,78,39,12,0,0,10,8,0,18,0,,
313,11,200,119,319,61,35,25,0,0,14,11,3,28,0,,
314,15,193,105,298,53,28,19,0,0,15,12,4,31,0,,
314,4,144,84,228,39,18,19,0,0,7,2,0,9,0,,
315,5,179,89,268,64,27,17,0,0,15,6,3,24,0,,
315,14,171,93,264,76,33,15,0,0,14,8,3,25,0,,
316,12,198,119,317,53,38,21,0,0,15,16,0,31,0,,
316,1,185,98,283,58,29,19,0,0,11,10,5,26,0,,
317,16,199,121,320,88,29,27,0,0,17,14,0,31,0,,
317,6,184,109,293,55,20,14,0,0,9,7,3,19,0,,
318,10,187,108,295,84,22,20,0,0,17,8,1,26,0,,
318,9,190,102,292,78,21,19,0,0,19,12,0,31,0,,
319,15,172,106,278,51,19,14,0,0,16,9,5,30,0,,
319,2,191,98,289,56,34,17,0,0,15,6,4,25,0,,
320,8,186,75,261,83,24,14,0,0,14,11,2,27,0,,
320,7,186,95,281,64,37,22,0,0,16,8,1,25,0,,
321,1,187,73,260,62,34,28,0,0,11,12,0,23,0,,
321,13,183,94,277,75,25,12,0,0,7,12,4,23,0,,
322,14,180,133,313,72,30,20,0,0,16,9,1,26,0,,
322,16,189,104,293,73,27,15,0,0,12,11,0,23,0,,
323,3,194,122,316,95,18,19,0,0,16,12,2,30,0,,
323,5,196,100,296,78,26,10,0,0,15,11,1,27,0,,
324,6,174,121,295,62,39,7,0,0,6,7,1,14,0,,
324,10,221,152,373,90,31,16,0,0,27,6,2,35,0,,
325,12,181,139,320,71,20,15,0,0,11,18,1,30,0,,
325,9,163,110,273,55,32,12,0,0,10,10,1,21,0,,
326,4,220,130,350,69,41,26,0,0,26,19,2,47,0,,
326,11,142,131,273,52,19,29,0,0,5,8,4,17,0,,
327,5,177,113,290,73,36,29,0,0,15,13,1,29,0,,
327,8,173,72,245,72,17,12,0,0,15,11,0,26,0,,
328,13,211,131,342,79,17,16,0,0,10,12,3,25,0,,
328,4,176,72,248,67,35,12,0,0,16,7,1,24,0,,
329,6,184,121,305,70,38,13,0,0,8,12,5,25,0,,
329,14,205,141,346,92,18,12,0,0,15,12,4,31,0,,
330,12,215,135,350,85,22,26,0,0,18,12,2,32,0,,
330,15,177,103,280,52,23,19,0,0,15,11,2,28,0,,
331,11,187,101,288,66,17,28,0,0,13,12,3,28,0,,
331,10,185,112,297,88,15,21,0,0,22,6,1,29,0,,
332,7,160,61,221,62,19,8,0,0,10,12,3,25,0,,
332,3,225,123,348,105,18,24,0,0,23,13,0,36,0,,
333,9,215,120,335,76,31,17,0,0,24,13,3,40,0,,
333,2,163,58,221,45,16,11,0,0,13,4,1,18,0,,
334,16,182,117,299,82,31,23,0,0,17,11,3,31,0,,
334,1,203,89,292,68,23,17,0,0,12,11,2,25,0,,
335,13,172,62,234,62,29,14,0,0,18,6,1,25,0,,
335,11,167,116,283,42,24,13,0,0,23,7,1,31,0,,
336,8,208,107,315,91,13,19,0,0,9,12,2,23,0,,
336,15,211,136,347,80,14,10,0,0,17,11,0,28,0,,
337,9,218,124,342,85,27,22,0,0,17,13,1,31,0,,
337,3,208,104,312,91,20,15,0,0,12,12,0,24,0,,
338,14,197,117,314,77,24,17,0,0,15,16,4,35,0,,
338,1,203,93,296,57,23,28,0,0,19,11,0,30,0,,
339,2,191,85,276,67,38,14,0,0,14,19,6,39,0,,
339,5,173,92,265,66,19,22,0,0,7,13,0,20,0,,
340,7,188,124,312,72,22,26,0,0,16,19,2,37,0,,
340,6,191,101,292,69,35,8,0,0,13,10,2,25,0,,
341,10,178,132,310,64,22,25,0,0,19,11,2,32,0,,
341,16,181,104,285,76,36,18,0,0,20,17,7,44,0,,
342,4,179,91,270,61,29,17,0,0,16,7,1,24,0,,
342,12,183,107,290,54,36,35,0,0,15,13,2,30,0,,
343,11,174,118,292,70,22,23,0,0,12,11,3,26,0,,
343,2,185,58,243,59,35,29,0,0,19,8,1,28,0,,
344,1,181,77,258,65,26,28,0,0,11,11,1,23,0,,
344,7,204,150,354,73,40,17,0,0,20,8,4,32,0,,
345,9,184,97,281,60,46,25,0,0,16,13,1,30,0,,
345,13,185,86,271,73,17,12,0,0,13,9,2,24,0,,
346,8,180,90,270,67,23,19,0,0,15,11,1,27,0,,
346,14,207,128,335,83,23,19,0,0,23,8,2,33,0,,
347,3,178,99,277,76,26,13,0,0,9,11,2,22,0,,
347,12,192,97,289,84,34,22,0,0,16,12,0,28,0,,
348,15,215,133,348,74,23,17,0,0,30,20,4,54,0,,
348,6,171,113,284,57,42,11,0,0,15,10,1,26,0,,
349,16,162,109,271,63,41,32,0,0,8,6,4,18,0,,
349,4,200,102,302,67,27,19,0,0,16,10,5,31,0,,
350,10,192,112,304,98,29,14,0,0,19,13,0,32,0,,
350,5,186,145,331,72,31,19,0,0,15,12,2,29,0,,
351,15,190,112,302,55,23,19,0,0,17,12,0,29,0,,
351,2,180,84,264,51,24,19,0,0,12,11,1,24,0,,
352,3,207,124,331,90,23,17,0,0,11,7,1,19,0,,
352,4,177,93,270,78,28,11,0,0,8,5,2,15,0,,
353,14,234,112,346,87,22,21,0,0,24,11,0,35,0,,
353,1,185,69,254,62,16,24,0,0,10,12,1,23,0,,
354,12,177,98,275,71,18,12,0,0,13,10,2,25,0,,
354,9,178,120,298,65,27,21,0,0,12,4,1,17,0,,
355,15,186,107,293,61,30,23,0,0,18,16,5,39,0,,
355,4,169,106,275,78,37,9,0,0,10,8,3,21,0,,
356,2,197,62,259,76,32,16,0,0,12,12,2,26,0,,
356,3,189,100,289,93,21,18,0,0,11,5,2,18,0,,
357,12,223,72,295,71,32,17,0,0,18,9,1,28,0,,
357,15,172,75,247,49,25,12,0,0,8,8,0,16,0,,
358,14,247,86,333,106,24,15,0,0,20,7,2,29,0,,
358,2,178,58,236,44,25,19,0,0,6,3,1,10,0,,
359,12,224,117,341,98,21,14,0,0,21,15,0,36,0,,
359,14,207,104,311,98,29,10,0,0,11,10,4,25,0,,
360,13,158,72,230,62,20,15,0,0,8,7,1,16,0,,
360,14,206,112,318,81,32,22,0,0,27,17,4,48,0,,
361,6,149,159,308,52,29,15,0,0,11,5,0,16,0,,
361,8,197,93,290,77,38,15,0,0,13,13,1,27,0,,
362,9,220,93,313,67,19,20,0,0,21,14,1,36,0,,
362,1,179,76,255,59,27,7,0,0,7,9,3,19,0,,
363,7,201,106,307,102,23,21,0,0,12,12,1,25,0,,
363,15,201,108,309,67,27,17,0,0,15,17,2,34,0,,
364,2,192,69,261,77,37,16,0,0,15,12,2,29,0,,
364,3,191,113,304,75,29,20,0,0,19,5,3,27,0,,
365,16,171,95,266,68,25,21,0,0,6,6,3,15,0,,
365,4,212,105,317,97,20,19,0,0,9,11,2,22,0,,
366,11,212,138,350,94,20,26,0,0,20,9,1,30,0,,
366,10,173,106,279,69,15,19,0,0,6,4,0,10,0,,
367,5,178,99,277,75,31,12,0,0,12,13,2,27,0,,
367,12,192,125,317,75,29,13,0,0,16,12,1,29,0,,
368,8,185,72,257,71,26,11,0,0,6,13,2,21,0,,
368,2,196,91,287,69,29,18,0,0,14,12,2,28,0,,
369,14,210,137,347,82,27,17,0,0,26,6,2,34,0,,
369,7,175,108,283,61,31,16,0,0,20,14,0,34,0,,
370,15,211,114,325,79,27,19,0,0,26,10,2,38,0,,
370,1,146,64,210,50,23,20,0,0,5,7,0,12,0,,
371,4,181,100,281,69,30,16,0,0,11,8,3,22,0,,
371,9,180,102,282,61,26,43,0,0,16,6,1,23,0,,
372,6,190,154,344,71,25,17,0,0,15,7,4,26,0,,
372,11,198,114,312,70,26,17,0,0,21,6,1,28,0,,
373,10,195,127,322,86,30,20,0,0,9,16,1,26,0,,
373,16,192,100,292,72,29,15,0,0,13,16,6,35,0,,
374,3,179,116,295,51,29,12,0,0,10,12,0,22,0,,
374,12,187,125,312,63,35,13,0,0,15,9,2,26,0,,
375,5,189,86,275,78,29,20,0,0,27,10,1,38,0,,
375,13,151,91,242,55,21,21,0,0,11,10,3,24,0,,
376,11,180,134,314,63,33,33,0,0,21,14,2,37,0,,
376,14,159,123,282,56,20,21,0,0,12,4,2,18,0,,
377,8,177,68,245,69,22,9,0,0,12,6,2,20,0,,
377,15,203,113,316,68,18,18,0,0,22,18,3,43,0,,
378,9,189,96,285,60,25,18,0,0,13,11,1,25,0,,
378,2,218,102,320,80,23,14,0,0,15,16,2,33,0,,
379,1,173,83,256,66,25,26,0,0,17,19,0,36,0,,
379,6,135,87,222,42,28,16,0,0,10,8,2,20,0,,
380,10,196,108,304,92,27,12,0,0,15,14,3,32,0,,
380,5,181,106,287,81,21,18,0,0,10,11,2,23,0,,
381,16,220,101,321,90,25,22,0,0,15,8,4,27,0,,
381,12,179,129,308,64,29,21,0,0,6,9,4,19,0,,
382,13,165,90,255,49,23,28,0,0,14,13,1,28,0,,
382,7,165,105,270,53,25,7,0,0,13,9,1,23,0,,
383,3,218,134,352,81,21,34,0,0,16,11,2,29,0,,
383,4,188,95,283,69,29,8,0,0,6,12,2,20,0,,
384,9,231,116,347,93,20,25,0,0,18,14,3,35,0,,
384,15,190,95,285,62,24,9,0,0,14,10,1,25,0,,
386,5,184,117,301,62,44,27,0,0,14,13,1,28,0,,
386,16,157,56,213,58,24,10,0,0,8,12,1,21,0,,
387,12,184,93,277,52,21,12,0,0,21,6,1,28,0,,
387,13,173,117,290,70,29,19,0,0,12,13,1,26,0,,
388,11,222,118,340,101,30,21,0,0,23,20,3,46,0,,
388,3,182,102,284,79,8,22,0,0,9,11,0,20,0,,
389,7,206,128,334,94,30,13,0,0,24,14,2,40,0,,
389,6,137,78,215,49,27,17,0,0,11,6,3,20,0,,
390,4,180,83,263,58,31,31,0,0,12,16,0,28,0,,
390,14,194,157,351,83,17,29,0,0,16,10,0,26,0,,
391,10,189,113,302,73,36,9,0,0,10,9,2,21,0,,
391,2,197,93,290,66,25,15,0,0,9,13,3,25,0,,
392,3,194,127,321,79,31,17,0,0,16,7,2,25,0,,
392,5,208,103,311,84,19,12,0,0,17,13,2,32,0,,
393,16,192,96,288,70,31,27,0,0,13,14,4,31,0,,
393,13,166,98,264,65,30,33,0,0,8,11,0,19,0,,
394,14,185,142,327,78,18,19,0,0,13,12,1,26,0,,
394,2,180,93,273,48,25,11,0,0,12,13,3,28,0,,
395,12,203,89,292,72,24,25,0,0,12,14,0,26,0,,
395,4,178,77,255,64,44,11,0,0,12,7,6,25,0,,
396,10,217,103,320,110,30,13,0,0,13,10,0,23,0,,
396,8,184,103,287,64,33,20,0,0,11,8,2,21,0,,
397,15,190,108,298,51,30,16,0,0,23,12,2,37,0,,
397,11,175,118,293,69,28,23,0,0,17,9,2,28,0,,
398,9,204,120,324,59,30,22,0,0,24,13,1,38,0,,
398,6,175,136,311,55,37,18,0,0,6,11,2,19,0,,
399,7,211,97,308,96,30,14,0,0,16,17,3,36,0,,
399,1,188,97,285,61,18,28,0,0,13,12,0,25,0,,
400,15,179,102,281,53,22,19,0,0,15,11,3,29,0,,
400,14,206,113,319,87,28,15,0,0,13,15,0,28,0,,
402,8,196,73,269,78,28,21,0,0,9,9,2,20,0,,
402,7,213,114,327,88,36,12,0,0,13,7,1,21,0,,
403,6,163,128,291,61,29,18,0,0,9,6,2,17,0,,
403,2,199,132,331,85,34,19,0,0,23,14,2,39,0,,
404,5,223,131,354,83,28,18,0,0,23,14,0,37,0,,
404,11,176,103,279,69,28,28,0,0,12,7,1,20,0,,
405,4,212,138,350,92,38,10,0,0,24,10,2,36,0,,
405,13,178,123,301,74,35,18,0,0,7,8,0,15,0,,
406,16,177,142,319,67,31,25,0,0,12,10,3,25,0,,
406,9,194,110,304,70,31,35,0,0,17,6,2,25,0,,
407,12,175,82,257,61,34,22,0,0,12,5,3,20,0,,
407,1,179,83,262,60,28,23,0,0,9,9,1,19,0,,
408,3,201,112,313,76,33,15,0,0,22,10,1,33,0,,
408,14,179,111,290,73,30,16,0,0,17,11,1,29,0,,
409,5,181,80,261,81,20,17,0,0,14,9,2,25,0,,
409,7,189,120,309,75,32,20,0,0,18,10,0,28,0,,
410,13,171,96,267,75,28,17,0,0,5,7,1,13,0,,
410,10,193,93,286,81,40,12,0,0,12,6,4,22,0,,
411,12,196,133,329,77,21,18,0,0,18,16,1,35,0,,
411,6,166,119,285,61,39,16,0,0,8,8,6,22,0,,
412,9,210,77,287,72,29,20,0,0,15,11,3,29,0,,
412,8,171,74,245,69,32,17,0,0,5,8,3,16,0,,
413,11,202,142,344,65,38,27,0,0,20,12,0,32,0,,
413,16,142,95,237,60,14,20,0,0,5,6,0,11,0,,
414,4,219,148,367,92,27,25,0,0,19,9,2,30,0,,
414,15,186,90,276,64,24,24,0,0,7,13,3,23,0,,
415,2,196,85,281,46,37,15,0,0,17,6,5,28,0,,
415,1,199,81,280,62,21,18,0,0,9,7,1,17,0,,
416,9,206,104,310,71,28,25,0,0,15,17,1,33,0,,
416,5,189,112,301,68,23,14,0,0,14,13,1,28,0,,
417,14,184,117,301,83,28,28,0,0,15,7,1,23,0,,
417,12,188,95,283,66,49,12,0,0,12,13,1,26,0,,
418,15,196,121,317,57,37,20,0,0,20,21,3,44,0,,
418,2,161,80,241,56,31,15,0,0,14,3,2,19,0,,
419,8,194,108,302,81,29,21,0,0,19,8,0,27,0,,
419,13,168,97,265,64,21,22,0,0,10,10,1,21,0,,
420,6,197,153,350,74,35,15,0,0,16,10,1,27,0,,
420,16,175,93,268,74,25,11,0,0,10,13,3,26,0,,
421,4,233,98,331,113,19,26,0,0,14,12,4,30,0,,
421,10,202,132,334,92,22,33,0,0,9,10,0,19,0,,
422,3,223,124,347,86,27,17,0,0,23,11,2,36,0,,
422,1,163,91,254,57,12,19,0,0,13,6,0,19,0,,
423,11,184,110,294,58,43,27,0,0,13,16,3,32,0,,
423,7,192,107,299,78,25,26,0,0,11,6,1,18,0,,
424,15,194,120,314,83,28,19,0,0,25,16,4,45,0,,
424,6,165,142,307,84,43,12,0,0,9,10,1,20,0,,
425,8,208,106,314,91,29,20,0,0,8,5,3,16,0,,
425,4,195,113,308,80,27,11,0,0,14,5,1,20,0,,
426,3,194,133,327,84,39,10,0,0,11,18,5,34,0,,
426,13,188,98,286,82,22,22,0,0,12,3,2,17,0,,
427,1,219,143,362,107,26,16,0,0,18,9,2,29,0,,
427,11,178,125,303,61,22,12,0,0,11,11,2,24,0,,
428,16,190,120,310,78,41,33,0,0,17,14,4,35,0,,
428,2,154,113,267,62,23,33,0,0,10,4,2,16,0,,
429,7,187,134,321,91,41,13,0,0,9,13,2,24,0,,
429,12,197,118,315,88,30,14,0,0,13,10,3,26,0,,
430,10,220,124,344,99,26,16,0,0,21,5,1,27,0,,
430,9,185,83,268,67,25,32,0,0,10,12,2,24,0,,
431,5,167,100,267,61,31,14,0,0,11,6,4,21,0,,
431,14,218,104,322,97,27,26,0,0,21,8,5,34,0,,
432,15,189,80,269,68,19,17,0,0,12,12,5,29,0,,
432,1,208,118,326,92,16,16,0,0,10,7,2,19,0,,
433,6,153,126,279,71,27,19,0,0,10,5,2,17,0,,
433,10,206,104,310,99,27,16,0,0,21,9,2,32,0,,
434,7,173,141,314,62,23,13,0,0,9,12,1,22,0,,
434,3,201,96,297,79,36,22,0,0,13,10,1,24,0,,
435,2,174,124,298,67,43,16,0,0,13,9,3,25,0,,
435,12,193,117,310,82,38,18,0,0,15,9,2,26,0,,
437,16,149,116,265,51,24,28,0,0,7,9,2,18,0,,
437,8,212,111,323,74,30,18,0,0,17,8,0,25,0,,
438,11,180,101,281,66,38,26,0,0,11,10,0,21,0,,
438,4,228,121,349,82,15,20,0,0,19,14,2,35,0,,
439,13,204,134,338,81,23,31,0,0,17,9,3,29,0,,
439,5,175,91,266,82,35,8,0,0,10,14,2,26,0,,
440,2,184,106,290,63,26,13,0,0,21,11,2,34,0,,
440,7,180,114,294,65,32,20,0,0,15,15,0,30,0,,
441,9,198,95,293,57,33,17,0,0,5,6,2,13,0,,
441,12,193,95,288,37,23,17,0,0,9,6,2,17,0,,
442,14,188,129,317,78,31,21,0,0,20,6,3,29,0,,
442,1,177,101,278,64,28,25,0,0,12,11,2,25,0,,
443,8,171,103,274,70,39,15,0,0,16,11,1,28,0,,
443,11,163,105,268,55,22,22,0,0,14,12,3,29,0,,
444,10,223,124,347,118,38,9,0,0,24,7,1,32,0,,
444,15,158,77,235,51,27,22,0,0,10,9,4,23,0,,
445,6,144,90,234,55,34,14,0,0,8,7,1,16,0,,
445,13,197,121,318,83,30,13,0,0,18,7,4,29,0,,
446,3,175,109,284,82,34,23,0,0,13,11,1,25,0,,
446,16,175,114,289,60,29,18,0,0,12,12,5,29,0,,
447,4,220,128,348,98,26,29,0,0,16,13,6,35,0,,
447,5,189,79,268,71,18,19,0,0,9,7,1,17,0,,
448,2,181,104,285,51,42,13,0,0,19,10,4,33,0,,
448,11,163,108,271,49,30,23,0,0,13,2,2,17,0,,
449,9,218,108,326,82,32,19,0,0,18,14,1,33,0,,
449,13,171,114,285,64,32,17,0,0,6,9,1,16,0,,
450,14,188,113,301,67,44,17,0,0,17,9,1,27,0,,
450,16,174,107,281,63,38,20,0,0,13,12,3,28,0,,
451,8,177,130,307,86,27,10,0,0,17,8,4,29,0,,
451,6,162,112,274,76,30,18,0,0,12,9,2,23,0,,
452,5,194,105,299,87,32,10,0,0,14,9,2,25,0,,
452,12,202,118,320,80,25,20,0,0,17,14,0,31,0,,
453,4,196,132,328,71,30,36,0,0,22,9,0,31,0,,
453,7,168,105,273,52,25,39,0,0,17,6,0,23,0,,
454,10,219,112,331,92,39,23,0,0,18,14,1,33,0,,
454,1,169,93,262,61,27,23,0,0,11,10,1,22,0,,
455,15,187,62,249,51,36,17,0,0,16,7,4,27,0,,
455,3,201,131,332,62,36,27,0,0,14,7,4,25,0,,
456,2,193,107,300,62,23,12,0,0,14,8,0,22,0,,
456,5,201,108,309,83,31,9,0,0,10,8,1,19,0,,
457,16,183,112,295,49,43,36,0,0,8,7,3,18,0,,
457,15,201,88,289,34,29,34,0,0,9,16,4,29,0,,
458,6,165,96,261,67,52,20,0,0,6,3,0,9,0,,
458,14,244,153,397,95,27,20,0,0,25,13,3,41,0,,
459,3,201,131,332,77,24,24,0,0,18,12,1,31,0,,
459,8,194,88,282,88,33,20,0,0,15,7,3,25,0,,
460,12,192,136,328,80,30,24,0,0,13,11,2,26,0,,
460,10,179,102,281,76,52,15,0,0,15,11,1,27,0,,
461,7,209,103,312,80,38,17,0,0,14,11,1,26,0,,
461,9,176,83,259,53,15,21,0,0,7,7,1,15,0,,
462,1,183,91,274,41,28,31,0,0,9,4,1,14,0,,
462,4,191,64,255,47,46,15,0,0,11,4,1,16,0,,
463,11,140,91,231,53,41,23,0,0,10,7,5,22,0,,
463,13,166,117,283,61,34,38,0,0,19,6,3,28,0,,
464,15,200,113,313,73,24,21,0,0,21,12,6,39,0,,
464,12,169,108,277,69,28,11,0,0,13,10,1,24,0,,
465,2,183,78,261,33,28,13,0,0,7,8,1,16,0,,
465,4,175,71,246,56,45,10,0,0,10,5,3,18,0,,
466,11,207,107,314,73,31,36,0,0,15,11,1,27,0,,
466,9,201,97,298,67,23,25,0,0,14,8,2,24,0,,
467,8,204,132,336,80,46,29,0,0,17,11,1,29,0,,
467,5,175,99,274,61,32,14,0,0,11,12,3,26,0,,
468,3,203,135,338,53,38,16,0,0,17,16,0,33,0,,
468,6,169,96,265,51,34,20,0,0,7,7,3,17,0,,
469,16,158,98,256,57,40,29,0,0,11,10,1,22,0,,
469,7,200,97,297,76,34,16,0,0,15,9,1,25,0,,
470,10,224,102,326,99,39,17,0,0,18,16,1,35,0,,
470,14,177,100,277,81,22,12,0,0,11,5,3,19,0,,
471,13,181,151,332,68,22,23,0,0,14,10,0,24,0,,
471,1,161,111,272,64,19,20,0,0,10,6,1,17,0,,
472,4,222,122,344,85,40,28,0,0,20,9,2,31,0,,
472,6,175,83,258,54,24,30,0,0,9,6,3,18,0,,
473,7,193,110,303,87,20,16,0,0,11,10,3,24,0,,
473,10,188,69,257,86,22,11,0,0,14,7,5,26,0,,
474,14,204,84,288,55,31,26,0,0,10,12,0,22,0,,
474,8,192,96,288,77,44,14,0,0,11,8,0,19,0,,
475,5,198,127,325,83,26,15,0,0,22,11,1,34,0,,
475,15,177,83,260,64,31,21,0,0,12,9,2,23,0,,
476,12,224,106,330,86,34,20,0,0,19,10,7,36,0,,
476,11,161,102,263,63,29,12,0,0,9,8,2,19,0,,
477,13,167,131,298,72,30,21,0,0,12,9,0,21,0,,
477,2,196,83,279,62,33,14,0,0,18,13,6,37,0,,
478,1,209,93,302,79,31,14,0,0,18,8,1,27,0,,
478,16,163,91,254,62,30,20,0,0,15,8,1,24,0,,
479,9,183,102,285,52,33,16,0,0,15,11,2,28,0,,
479,3,165,80,245,66,35,22,0,0,10,7,1,18,0,,
480,15,235,96,331,74,37,15,0,0,17,13,3,33,0,,
480,7,173,71,244,46,27,20,0,0,4,5,0,9,0,,
481,14,185,94,279,45,23,16,0,0,13,8,2,23,0,,
481,13,160,64,224,54,21,22,0,0,4,6,0,10,0,,
482,3,217,99,316,86,39,22,0,0,15,15,3,33,0,,
482,2,174,91,265,69,24,11,0,0,13,9,1,23,0,,
483,8,219,107,326,62,37,25,0,0,15,6,2,23,0,,
483,12,206,87,293,56,22,9,0,0,7,4,3,14,0,,
484,1,179,61,240,49,24,23,0,0,3,3,1,7,0,,
484,9,208,90,298,62,30,10,0,0,4,10,2,16,0,,
485,5,167,134,301,80,27,11,0,0,17,12,2,31,0,,
485,6,154,95,249,53,46,24,0,0,10,13,3,26,0,,
486,4,213,123,336,51,38,40,0,0,12,8,2,22,0,,
486,16,171,109,280,43,35,38,0,0,7,6,0,13,0,,
487,10,193,113,306,86,35,21,0,0,16,14,0,30,0,,
487,11,192,142,334,71,29,20,0,0,12,12,4,28,0,,
488,13,155,121,276,49,24,27,0,0,11,3,1,15,0,,
488,15,233,114,347,96,39,10,0,0,28,11,4,43,0,,
489,9,201,128,329,63,37,30,0,0,25,9,4,38,0,,
489,4,173,107,280,59,38,6,0,0,17,13,1,31,0,,
490,7,211,91,302,93,20,28,0,0,14,12,4,30,0,,
490,14,172,93,265,65,28,21,0,0,11,8,2,21,0,,
491,3,195,135,330,71,35,13,0,0,11,12,4,27,0,,
491,12,190,112,302,76,32,17,0,0,13,11,2,26,0,,
492,2,209,107,316,69,38,18,0,0,17,10,2,29,0,,
492,8,184,120,304,74,34,26,0,0,11,5,2,18,0,,
493,16,191,110,301,72,41,49,0,0,15,12,2,29,0,,
493,10,186,115,301,62,40,17,0,0,12,5,1,18,0,,
494,5,197,129,326,88,28,18,0,0,17,10,2,29,0,,
494,1,186,103,289,72,15,16,0,0,16,8,4,28,0,,
495,11,177,163,340,81,26,19,0,0,26,8,2,36,0,,
495,6,173,105,278,77,18,30,0,0,9,11,2,22,0,,
496,15,212,107,319,70,20,10,0,0,19,14,2,35,0,,
496,8,192,111,303,82,35,19,0,0,15,7,2,24,0,,
497,12,205,160,365,88,46,16,0,0,23,6,1,30,0,,
497,16,189,94,283,68,34,13,0,0,11,13,5,29,0,,
498,7,187,106,293,62,35,21,0,0,13,9,1,23,0,,
498,5,194,122,316,73,28,18,0,0,11,12,0,23,0,,
499,14,193,115,308,60,38,27,0,0,15,12,2,29,0,,
499,11,180,127,307,52,22,29,0,0,10,7,2,19,0,,
500,6,173,134,307,49,40,18,0,0,6,8,1,15,0,,
500,1,198,104,302,64,32,24,0,0,8,12,0,20,0,,
436,14,179,104,283,68,26,16,0,0,14,11,3,28,0,,
401,10,174,91,265,78,30,13,0,0,14,5,1,20,0,,
385,1,198,81,279,68,25,24,0,0,8,8,1,17,0,,
287,2,175,59,234,52,38,22,0,0,15,7,4,26,0,,
267,5,171,93,264,49,27,27,0,0,10,10,1,21,0,,
206,5,170,87,257,57,24,20,0,0,17,8,1,26,0,,
501,10,212,137,349,95,32,15,0,0,17,13,0,30,0,,
501,13,172,123,295,69,20,27,0,0,6,12,4,22,0,,
502,4,210,117,327,72,30,23,0,0,14,12,3,29,0,,
502,3,202,100,302,75,29,24,0,0,14,6,3,23,0,,
503,9,182,105,287,34,56,26,0,0,9,13,3,25,0,,
503,2,168,85,253,32,34,9,0,0,7,9,2,18,0,,
504,16,195,113,308,85,35,21,0,0,15,12,4,31,0,,
504,5,184,132,316,59,31,15,0,0,11,14,2,27,0,,
505,14,210,133,343,79,34,24,0,0,18,15,4,37,0,,
505,4,177,102,279,61,39,14,0,0,12,9,1,22,0,,
506,6,169,147,316,57,47,15,0,0,5,4,1,10,0,,
506,7,218,103,321,74,44,18,0,0,13,9,1,23,0,,
507,8,224,97,321,114,33,24,0,0,20,10,2,32,0,,
507,1,169,67,236,59,20,20,0,0,10,5,0,15,0,,
508,13,190,117,307,57,24,25,0,0,20,7,2,29,0,,
508,12,179,103,282,75,24,16,0,0,17,7,1,25,0,,
509,3,222,160,382,91,29,25,0,0,21,17,0,38,0,,
509,11,171,108,279,67,18,18,0,0,16,10,1,27,0,,
510,10,202,106,308,78,36,18,0,0,20,9,1,30,0,,
510,2,171,105,276,62,23,16,0,0,12,9,1,22,0,,
511,9,195,113,308,66,41,25,0,0,11,11,0,22,0,,
511,15,174,109,283,49,28,19,0,0,8,10,1,19,0,,
512,13,188,122,310,64,20,18,0,0,13,11,3,27,0,,
512,16,151,96,247,61,35,16,0,0,10,8,3,21,0,,
513,8,189,120,309,70,26,20,0,0,7,7,0,14,0,,
513,10,202,94,296,73,38,17,0,0,9,15,3,27,0,,
514,11,183,89,272,46,41,30,0,0,10,8,2,20,0,,
514,15,184,90,274,30,14,16,0,0,10,9,7,26,0,,
515,2,217,103,320,72,48,18,0,0,19,15,3,37,0,,
515,14,177,117,294,61,31,12,0,0,9,11,2,22,0,,
516,9,199,123,322,79,32,24,0,0,29,12,1,42,0,,
516,6,171,114,285,52,38,17,0,0,14,14,2,30,0,,
517,5,188,100,288,65,34,22,0,0,9,9,1,19,0,,
517,3,215,106,321,80,35,22,0,0,11,10,1,22,0,,
518,4,183,109,292,51,35,16,0,0,19,11,2,32,0,,
518,12,178,103,281,54,22,35,0,0,10,7,1,18,0,,
519,1,224,75,299,81,29,20,0,0,14,7,4,25,0,,
519,7,166,110,276,55,19,21,0,0,8,6,3,17,0,,
520,15,159,92,251,55,25,26,0,0,14,10,2,26,0,,
520,14,201,108,309,95,32,17,0,0,16,10,3,29,0,,
521,3,211,125,336,92,22,15,0,0,14,16,0,30,0,,
521,10,189,78,267,91,34,9,0,0,12,9,1,22,0,,
522,12,212,132,344,92,43,13,0,0,13,15,3,31,0,,
522,1,176,118,294,66,25,19,0,0,9,10,2,21,0,,
523,9,190,96,286,52,35,25,0,0,10,7,4,21,0,,
523,16,188,124,312,75,40,22,0,0,10,8,2,20,0,,
524,7,172,101,273,63,23,11,0,0,9,9,0,18,0,,
524,8,182,82,264,85,32,22,0,0,12,6,2,20,0,,
525,11,181,113,294,73,20,24,0,0,14,10,2,26,0,,
525,5,197,135,332,85,19,28,0,0,24,8,1,33,0,,
526,4,216,129,345,102,28,9,0,0,24,7,0,31,0,,
526,13,185,126,311,72,25,24,0,0,11,10,2,23,0,,
527,2,248,160,408,113,25,13,0,0,28,18,1,47,0,,
527,6,133,139,272,48,30,24,0,0,5,5,1,11,0,,
528,3,183,126,309,103,27,18,0,0,11,11,2,24,0,,
528,1,200,87,287,81,19,15,0,0,11,6,4,21,0,,
529,13,187,103,290,87,12,12,0,0,15,10,1,26,0,,
529,8,160,94,254,71,35,21,0,0,15,9,3,27,0,,
530,14,178,91,269,67,28,18,0,0,9,10,1,20,0,,
530,12,198,113,311,92,36,14,0,0,16,9,2,27,0,,
531,5,207,172,379,78,47,10,0,0,15,7,3,25,0,,
531,9,181,111,292,59,41,18,0,0,6,12,3,21,0,,
532,7,227,133,360,100,28,31,0,0,20,23,1,44,0,,
532,11,161,126,287,78,20,18,0,0,11,6,3,20,0,,
533,10,212,70,282,45,34,25,0,0,12,10,3,25,0,,
533,4,179,73,252,54,47,22,0,0,6,9,5,20,0,,
534,2,180,106,286,62,29,11,0,0,16,12,1,29,0,,
534,15,200,92,292,77,29,20,0,0,21,13,2,36,0,,
535,16,181,123,304,85,31,36,0,0,24,11,2,37,0,,
535,6,142,119,261,58,17,25,0,0,10,9,2,21,0,,
536,9,183,92,275,63,37,31,0,0,15,7,4,26,0,,
536,3,185,115,300,65,40,29,0,0,15,10,0,25,0,,
537,10,185,75,260,76,36,11,0,0,13,9,3,25,0,,
537,8,191,108,299,71,26,21,0,0,12,8,4,24,0,,
538,4,213,106,319,74,43,28,0,0,18,13,4,35,0,,
538,12,171,118,289,56,21,32,0,0,10,6,4,20,0,,
539,15,182,108,290,56,34,19,0,0,19,13,4,36,0,,
539,14,199,94,293,93,30,24,0,0,9,12,5,26,0,,
540,3,208,139,347,85,26,27,0,0,22,11,1,34,0,,
540,4,170,101,271,75,39,6,0,0,8,12,7,27,0,,
541,9,234,99,333,86,29,20,0,0,26,10,4,40,0,,
541,12,188,110,298,78,22,18,0,0,10,12,1,23,0,,
542,15,184,83,267,84,22,13,0,0,17,11,1,29,0,,
542,9,185,104,289,62,28,22,0,0,11,8,2,21,0,,
543,10,192,76,268,73,45,18,0,0,10,8,2,20,0,,
543,3,183,142,325,71,29,18,0,0,10,9,0,19,0,,
544,15,205,103,308,82,27,10,0,0,19,12,5,36,0,,
544,10,187,108,295,65,37,27,0,0,13,8,2,23,0,,
545,15,184,60,244,39,25,9,0,0,7,9,4,20,0,,
545,13,178,81,259,64,26,21,0,0,10,6,4,20,0,,
546,1,187,84,271,70,34,27,0,0,11,8,2,21,0,,
546,16,187,107,294,72,35,19,0,0,10,17,3,30,0,,
547,5,189,119,308,79,30,14,0,0,26,10,0,36,0,,
547,18,172,93,265,56,28,22,0,0,13,7,2,22,0,,
548,4,198,105,303,73,16,20,0,0,12,6,0,18,0,,
548,10,203,111,314,70,28,14,0,0,5,6,1,12,0,,
549,7,174,103,277,79,28,15,0,0,10,10,1,21,0,,
549,8,169,77,246,54,32,29,0,0,11,8,3,22,0,,
550,11,187,115,302,50,30,33,0,0,20,11,1,32,0,,
550,9,177,85,262,43,19,22,0,0,14,11,1,26,0,,
551,2,180,94,274,61,37,24,0,0,15,13,1,29,0,,
551,14,159,82,241,66,32,17,0,0,13,15,2,30,0,,
552,3,206,113,319,79,22,18,0,0,16,8,2,26,0,,
552,12,194,111,305,82,33,22,0,0,15,8,1,24,0,,
553,13,157,93,250,62,23,7,0,0,7,11,3,21,0,,
553,5,203,129,332,89,34,21,0,0,24,16,3,43,0,,
554,14,193,88,281,86,26,24,0,0,11,8,4,23,0,,
554,4,178,110,288,65,39,10,0,0,11,6,0,17,0,,
555,1,176,92,268,76,29,25,0,0,13,10,2,25,0,,
555,10,195,93,288,84,32,22,0,0,12,8,3,23,0,,
556,2,197,107,304,79,39,27,0,0,19,13,1,33,0,,
556,11,170,89,259,58,37,10,0,0,15,10,0,25,0,,
557,16,195,119,314,73,16,25,0,0,13,6,3,22,0,,
557,8,203,98,301,66,35,21,0,0,10,10,3,23,0,,
558,9,201,89,290,62,31,20,0,0,23,14,2,39,0,,
558,7,169,97,266,53,24,21,0,0,7,13,2,22,0,,
559,18,164,111,275,58,22,34,0,0,8,10,2,20,0,,
559,3,180,79,259,71,23,18,0,0,14,9,0,23,0,,
560,15,215,79,294,58,44,12,0,0,12,13,1,26,0,,
560,12,201,123,324,73,39,14,0,0,8,9,3,20,0,,
561,10,200,110,310,60,34,28,0,0,15,6,3,24,0,,
561,13,173,132,305,53,24,21,0,0,14,7,0,21,0,,
562,18,198,97,295,68,19,17,0,0,18,19,2,39,0,,
562,14,184,102,286,84,22,21,0,0,14,6,0,20,0,,
563,2,174,97,271,57,23,15,0,0,12,11,3,26,0,,
563,1,196,87,283,73,25,18,0,0,16,7,2,25,0,,
564,7,206,122,328,90,21,16,0,0,19,9,2,30,0,,
564,5,185,114,299,67,28,15,0,0,17,16,0,33,0,,
565,8,186,108,294,81,37,14,0,0,12,12,3,27,0,,
565,9,161,84,245,46,36,22,0,0,11,7,2,20,0,,
566,3,241,125,366,104,25,18,0,0,18,10,4,32,0,,
566,15,195,98,293,66,22,11,0,0,12,7,1,20,0,,
567,4,185,146,331,71,28,22,0,0,16,12,3,31,0,,
567,16,182,117,299,84,20,24,0,0,9,13,4,26,0,,
568,12,207,127,334,77,19,17,0,0,15,15,3,33,0,,
568,11,175,75,250,66,26,10,0,0,12,8,0,20,0,,
569,13,170,99,269,68,14,19,0,0,13,8,1,22,0,,
569,1,179,79,258,68,21,14,0,0,13,9,2,24,0,,
570,7,167,108,275,72,6,20,0,0,12,6,3,21,0,,
570,10,203,109,312,83,24,25,0,0,18,15,4,37,0,,
571,4,218,132,350,71,35,32,0,0,17,7,3,27,0,,
571,8,203,151,354,73,24,23,0,0,13,9,1,23,0,,
572,5,169,96,265,77,24,14,0,0,12,10,2,24,0,,
572,12,200,99,299,86,31,20,0,0,15,8,3,26,0,,
573,2,196,91,287,70,37,12,0,0,10,10,2,22,0,,
573,16,180,94,274,72,34,18,0,0,10,6,1,17,0,,
574,3,170,101,271,62,39,6,0,0,11,10,2,23,0,,
574,14,206,102,308,84,21,26,0,0,11,18,1,30,0,,
575,11,190,96,286,79,35,20,0,0,11,5,1,17,0,,
575,18,215,116,331,91,21,30,0,0,11,15,2,28,0,,
576,9,205,87,292,77,16,24,0,0,15,16,3,34,0,,
576,15,187,82,269,70,20,9,0,0,12,11,0,23,0,,
577,16,189,106,295,75,27,34,0,0,16,10,1,27,0,,
577,7,186,122,308,67,24,26,0,0,15,8,3,26,0,,
578,3,184,92,276,70,41,15,0,0,10,7,3,20,0,,
578,5,184,85,269,76,31,25,0,0,14,12,3,29,0,,
579,13,180,108,288,71,17,24,0,0,12,6,0,18,0,,
579,4,204,113,317,78,35,22,0,0,19,9,3,31,0,,
580,8,187,107,294,62,29,34,0,0,15,5,4,24,0,,
580,10,169,92,261,65,28,15,0,0,11,7,1,19,0,,
581,1,210,85,295,102,26,18,0,0,9,11,6,26,0,,
581,11,202,91,293,91,27,28,0,0,19,6,1,26,0,,
582,18,194,130,324,73,24,21,0,0,10,12,1,23,0,,
582,9,209,122,331,72,23,22,0,0,10,10,1,21,0,,
583,15,216,124,340,71,35,22,0,0,21,12,3,36,0,,
583,2,159,104,263,51,24,9,0,0,7,3,1,11,0,,
584,12,177,100,277,78,25,18,0,0,12,12,2,26,0,,
584,14,194,94,288,82,33,15,0,0,13,14,2,29,0,,
585,4,186,89,275,66,38,31,0,0,14,13,2,29,0,,
585,1,204,91,295,69,21,24,0,0,17,8,3,28,0,,
586,8,186,89,275,57,20,31,0,0,14,6,3,23,0,,
586,15,181,71,252,47,24,18,0,0,16,3,4,23,0,,
587,3,218,135,353,87,20,7,0,0,15,11,1,27,0,,
587,9,180,85,265,72,40,23,0,0,9,11,6,26,0,,
588,14,222,112,334,78,34,17,0,0,14,11,2,27,0,,
588,16,161,74,235,47,23,14,0,0,6,6,1,13,0,,
589,5,188,108,296,87,22,10,0,0,13,5,1,19,0,,
589,11,213,61,274,78,22,23,0,0,11,14,3,28,0,,
590,18,209,116,325,66,26,35,0,0,19,7,1,27,0,,
590,2,189,128,317,74,26,22,0,0,8,8,2,18,0,,
591,7,200,93,293,72,39,16,0,0,17,15,4,36,0,,
591,13,143,68,211,62,31,25,0,0,4,7,4,15,0,,
592,10,201,128,329,58,26,22,0,0,21,16,0,37,0,,
592,12,186,110,296,78,19,14,0,0,11,15,2,28,0,,
593,15,172,77,249,59,29,12,0,0,9,8,6,23,0,,
593,5,180,104,284,71,39,16,0,0,17,7,2,26,0,,
594,14,202,111,313,92,28,20,0,0,11,9,1,21,0,,
594,10,158,116,274,52,28,18,0,0,6,7,1,14,0,,
595,16,200,120,320,71,30,24,0,0,17,20,2,39,0,,
595,13,160,88,248,53,18,25,0,0,10,6,3,19,0,,
596,1,194,108,302,74,29,19,0,0,19,14,5,38,0,,
596,8,171,84,255,69,39,17,0,0,13,9,1,23,0,,
597,7,224,136,360,88,32,22,0,0,20,5,1,26,0,,
597,18,173,82,255,64,28,22,0,0,8,12,1,21,0,,
598,2,189,88,277,74,29,11,0,0,10,9,7,26,0,,
598,12,192,117,309,73,20,15,0,0,14,13,1,28,0,,
599,11,211,89,300,88,26,39,0,0,18,13,5,36,0,,
599,3,183,105,288,91,15,18,0,0,11,7,0,18,0,,
600,9,165,110,275,66,35,20,0,0,8,9,3,20,0,,
600,4,203,122,325,85,32,20,0,0,21,10,3,34,0,,
601,5,180,95,275,71,26,13,0,0,19,11,4,34,0,,
601,1,191,106,297,77,22,19,0,0,11,15,2,28,0,,
602,11,227,109,336,97,25,27,0,0,22,10,2,34,0,,
602,10,187,135,322,70,21,19,0,0,8,7,0,15,0,,
603,13,153,96,249,50,24,24,0,0,7,7,0,14,0,,
603,14,200,109,309,94,32,8,0,0,19,11,3,33,0,,
604,15,190,87,277,72,25,9,0,0,19,11,3,33,0,,
604,18,190,92,282,74,38,23,0,0,15,9,1,25,0,,
605,16,187,129,316,70,16,22,0,0,14,13,1,28,0,,
605,9,159,112,271,50,51,22,0,0,15,2,1,18,0,,
606,3,185,105,290,65,24,17,0,0,14,15,1,30,0,,
606,7,181,94,275,87,26,34,0,0,18,11,5,34,0,,
607,12,217,159,376,91,21,20,0,0,15,12,4,31,0,,
607,8,178,120,298,73,34,21,0,0,12,7,2,21,0,,
608,2,192,117,309,52,37,20,0,0,18,7,4,29,0,,
608,4,185,115,300,70,29,11,0,0,9,9,4,22,0,,
609,7,191,120,311,78,30,27,0,0,22,8,1,31,0,,
609,2,167,69,236,43,39,15,0,0,14,7,3,24,0,,
610,18,177,92,269,44,28,15,0,0,10,14,4,28,0,,
610,13,198,81,279,99,19,14,0,0,3,5,4,12,0,,
611,12,184,121,305,69,21,10,0,0,16,9,0,25,0,,
611,16,171,104,275,73,26,19,0,0,14,3,1,18,0,,
612,10,210,106,316,74,24,18,0,0,16,14,1,31,0,,
612,5,158,90,248,51,30,13,0,0,11,7,1,19,0,,
613,8,181,125,306,78,31,16,0,0,13,7,3,23,0,,
613,11,199,82,281,82,21,19,0,0,14,15,3,32,0,,
614,9,195,115,310,68,40,30,0,0,19,9,3,31,0,,
614,14,176,122,298,64,31,19,0,0,15,8,0,23,0,,
615,15,169,72,241,56,31,11,0,0,10,7,4,21,0,,
615,1,211,113,324,96,20,25,0,0,16,6,1,23,0,,
616,4,185,116,301,81,16,26,0,0,16,12,2,30,0,,
616,3,178,97,275,69,16,22,0,0,13,5,2,20,0,,
617,18,215,85,300,66,19,25,0,0,14,7,2,23,0,,
617,12,176,130,306,56,27,19,0,0,7,13,0,20,0,,
618,14,206,90,296,92,27,13,0,0,16,10,1,27,0,,
618,7,170,114,284,62,34,29,0,0,11,9,4,24,0,,
619,2,160,79,239,54,33,15,0,0,9,11,2,22,0,,
619,13,197,82,279,69,41,25,0,0,14,5,3,22,0,,
620,8,193,110,303,84,39,25,0,0,16,12,0,28,0,,
620,5,159,71,230,84,32,22,0,0,8,5,2,15,0,,
621,15,190,96,286,76,26,19,0,0,15,12,1,28,0,,
621,4,171,98,269,71,29,11,0,0,9,2,2,13,0,,
622,3,174,100,274,80,28,22,0,0,17,8,4,29,0,,
622,1,199,114,313,82,27,24,0,0,20,13,3,36,0,,
623,9,193,112,305,77,39,27,0,0,13,11,3,27,0,,
623,10,182,119,301,64,24,20,0,0,13,8,3,24,0,,
624,16,220,116,336,94,18,13,0,0,10,11,1,22,0,,
624,11,213,137,350,72,30,37,0,0,16,6,3,25,0,,
625,5,167,81,248,63,31,20,0,0,10,9,2,21,0,,
625,2,206,99,305,75,35,15,0,0,11,7,4,22,0,,
626,18,179,111,290,76,23,22,0,0,4,10,7,21,0,,
626,10,198,108,306,74,29,16,0,0,10,11,5,26,0,,
627,1,190,96,286,74,23,21,0,0,14,10,2,26,0,,
627,14,194,79,273,80,32,19,0,0,11,7,2,20,0,,
628,3,180,139,319,74,28,22,0,0,13,12,1,26,0,,
628,8,204,110,314,96,32,21,0,0,17,20,2,39,0,,
629,4,181,82,263,53,38,24,0,0,11,6,1,18,0,,
629,7,194,83,277,51,17,26,0,0,13,10,1,24,0,,
630,13,184,115,299,70,24,14,0,0,5,11,4,20,0,,
630,11,206,77,283,95,33,21,0,0,14,12,1,27,0,,
631,12,224,124,348,113,35,10,0,0,12,11,1,24,0,,
631,9,184,102,286,71,27,17,0,0,9,6,3,18,0,,
632,15,189,100,289,64,29,14,0,0,15,13,2,30,0,,
632,16,187,116,303,90,29,19,0,0,12,5,2,19,0,,
633,10,197,102,299,67,24,24,0,0,26,8,0,34,0,,
633,2,221,115,336,90,31,15,0,0,16,12,2,30,0,,
634,14,182,61,243,61,21,16,0,0,12,10,0,22,0,,
634,8,166,95,261,56,30,14,0,0,13,8,2,23,0,,
635,1,211,137,348,96,25,17,0,0,12,10,0,22,0,,
635,18,185,105,290,58,26,20,0,0,14,8,2,24,0,,
636,5,179,117,296,60,26,26,0,0,7,13,0,20,0,,
636,4,176,91,267,68,30,11,0,0,11,5,0,16,0,,
637,11,204,95,299,68,20,43,0,0,12,8,3,23,0,,
637,15,205,85,290,56,27,9,0,0,16,7,2,25,0,,
638,16,207,121,328,86,29,29,0,0,24,10,3,37,0,,
638,3,181,121,302,61,25,20,0,0,9,5,1,15,0,,
639,7,197,112,309,75,33,34,0,0,16,18,2,36,0,,
639,12,186,114,300,76,21,20,0,0,12,11,2,25,0,,
640,13,147,93,240,53,21,13,0,0,7,5,3,15,0,,
640,9,202,89,291,88,33,18,0,0,21,7,2,30,0,,
641,4,208,105,313,78,31,31,0,0,11,11,2,24,0,,
641,12,199,144,343,79,25,28,0,0,12,12,2,26,0,,
642,18,196,115,311,61,29,22,0,0,10,8,1,19,0,,
642,16,180,107,287,62,26,19,0,0,7,11,1,19,0,,
643,7,188,95,283,69,31,21,0,0,11,14,4,29,0,,
643,1,200,86,286,62,30,23,0,0,15,9,2,26,0,,
644,2,183,86,269,81,26,11,0,0,4,6,4,14,0,,
644,3,253,137,390,122,32,18,0,0,19,11,2,32,0,,
645,14,201,112,313,92,24,15,0,0,17,8,0,25,0,,
645,11,148,80,228,41,37,15,0,0,7,8,4,19,0,,
646,8,188,120,308,69,22,18,0,0,17,14,2,33,0,,
646,13,156,78,234,57,24,19,0,0,7,12,1,20,0,,
647,10,192,67,259,51,28,20,0,0,8,12,5,25,0,,
647,15,182,64,246,46,26,12,0,0,7,9,4,20,0,,
648,9,218,110,328,95,24,17,0,0,11,18,4,33,0,,
648,5,182,94,276,74,26,11,0,0,11,6,1,18,0,,
649,11,220,120,340,85,40,28,0,0,16,5,5,26,0,,
649,4,168,106,274,60,25,23,0,0,4,6,1,11,0,,
650,16,181,109,290,57,17,31,0,0,6,8,4,18,0,,
650,10,200,116,316,44,28,15,0,0,3,15,0,18,0,,
651,5,174,104,278,80,36,20,0,0,10,10,2,22,0,,
651,14,190,131,321,71,31,17,0,0,9,21,5,35,0,,
652,12,172,83,255,63,21,17,0,0,11,7,1,19,0,,
652,1,199,96,295,75,27,23,0,0,16,12,2,30,0,,
653,7,216,140,356,91,31,29,0,0,20,13,0,33,0,,
653,15,168,67,235,54,18,8,0,0,11,10,3,24,0,,
654,8,219,139,358,92,15,26,0,0,18,13,3,34,0,,
654,18,188,90,278,72,22,15,0,0,13,12,2,27,0,,
655,3,211,122,333,95,18,11,0,0,18,10,2,30,0,,
655,13,157,87,244,64,18,12,0,0,8,8,1,17,0,,
656,9,200,104,304,86,32,19,0,0,7,22,4,33,0,,
656,2,176,82,258,56,21,20,0,0,7,8,0,15,0,,
657,15,174,75,249,54,23,17,0,0,14,6,2,22,0,,
657,14,184,87,271,63,32,15,0,0,15,11,1,27,0,,
658,1,164,129,293,52,26,25,0,0,11,6,1,18,0,,
658,9,208,118,326,92,45,27,0,0,21,8,3,32,0,,
659,5,203,125,328,91,29,22,0,0,25,8,2,35,0,,
659,16,145,72,217,62,28,12,0,0,9,3,3,15,0,,
660,11,208,79,287,66,36,35,0,0,10,12,4,26,0,,
660,7,187,123,310,45,29,22,0,0,9,10,2,21,0,,
661,13,182,102,284,80,16,21,0,0,18,8,3,29,0,,
661,12,188,101,289,86,23,11,0,0,15,10,0,25,0,,
662,4,204,99,303,65,30,32,0,0,12,13,0,25,0,,
662,18,182,72,254,39,24,26,0,0,9,12,1,22,0,,
663,2,197,80,277,58,19,23,0,0,22,11,2,35,0,,
663,8,159,91,250,53,32,20,0,0,10,7,2,19,0,,
664,10,207,87,294,89,29,23,0,0,11,10,3,24,0,,
664,3,189,129,318,87,31,21,0,0,11,9,3,23,0,,
665,9,231,127,358,95,38,11,0,0,17,12,4,33,0,,
665,11,180,76,256,55,23,19,0,0,13,9,0,22,0,,
666,10,207,106,313,73,27,23,0,0,15,20,2,37,0,,
666,4,164,81,245,60,39,22,0,0,11,9,0,20,0,,
667,8,162,108,270,55,25,16,0,0,9,5,3,17,0,,
667,7,208,121,329,87,31,28,0,0,20,18,3,41,0,,
668,14,204,119,323,83,34,24,0,0,16,9,5,30,0,,
668,2,165,98,263,66,35,13,0,0,12,3,3,18,0,,
669,18,183,92,275,52,24,24,0,0,17,7,2,26,0,,
669,5,187,92,279,102,29,25,0,0,8,6,4,18,0,,
670,3,185,126,311,76,18,14,0,0,13,6,3,22,0,,
670,12,208,115,323,107,25,33,0,0,25,12,3,40,0,,
671,13,172,96,268,78,13,16,0,0,7,13,3,23,0,,
671,15,198,91,289,67,29,13,0,0,17,10,2,29,0,,
672,16,182,110,292,100,36,20,0,0,15,6,1,22,0,,
672,1,189,105,294,64,22,20,0,0,13,9,4,26,0,,
673,3,183,108,291,87,21,5,0,0,10,11,1,22,0,,
673,18,174,96,270,68,40,21,0,0,18,12,2,32,0,,
674,12,203,114,317,71,18,14,0,0,7,11,5,23,0,,
674,15,194,104,298,63,26,18,0,0,14,12,0,26,0,,
675,11,215,118,333,71,41,39,0,0,29,10,1,40,0,,
675,2,163,74,237,47,28,24,0,0,7,6,0,13,0,,
676,8,173,124,297,62,36,23,0,0,9,8,0,17,0,,
676,16,173,92,265,67,37,18,0,0,10,10,1,21,0,,
677,10,201,106,307,87,43,14,0,0,22,11,6,39,0,,
677,1,150,102,252,62,25,30,0,0,7,9,1,17,0,,
678,7,217,88,305,90,32,18,0,0,12,15,5,32,0,,
678,9,177,98,275,81,22,19,0,0,5,12,2,19,0,,
679,5,196,108,304,73,50,15,0,0,20,14,0,34,0,,
679,13,168,90,258,60,21,16,0,0,12,8,2,22,0,,
680,4,205,111,316,76,30,22,0,0,20,7,2,29,0,,
680,14,188,107,295,68,26,27,0,0,12,10,0,22,0,,
681,15,194,92,286,71,22,15,0,0,11,16,1,28,0,,
681,3,176,112,288,78,25,15,0,0,8,14,2,24,0,,
682,13,150,103,253,59,21,19,0,0,7,9,2,18,0,,
682,10,220,147,367,91,19,22,0,0,25,15,4,44,0,,
683,14,208,133,341,92,41,18,0,0,25,7,2,34,0,,
683,18,156,75,231,55,32,21,0,0,11,8,0,19,0,,
684,1,167,109,276,64,30,18,0,0,15,6,4,25,0,,
684,2,164,112,276,58,40,22,0,0,17,10,3,30,0,,
685,9,231,93,324,113,29,20,0,0,21,12,3,36,0,,
685,8,171,103,274,67,24,14,0,0,11,5,0,16,0,,
686,16,194,81,275,68,37,26,0,0,7,5,2,14,0,,
686,4,190,106,296,66,27,19,0,0,13,4,0,17,0,,
687,5,172,104,276,64,36,22,0,0,12,15,2,29,0,,
687,7,196,104,300,66,23,23,0,0,15,17,4,36,0,,
688,11,198,84,282,83,32,27,0,0,18,19,0,37,0,,
688,12,193,122,315,81,27,18,0,0,13,7,1,21,0,,
689,15,208,103,311,70,36,10,0,0,17,12,2,31,0,,
689,9,161,82,243,55,36,22,0,0,9,5,0,14,0,,
690,8,180,111,291,66,34,18,0,0,10,6,0,16,0,,
690,4,196,92,288,92,34,15,0,0,13,8,1,22,0,,
691,16,211,136,347,81,27,24,0,0,12,12,1,25,0,,
691,2,200,95,295,56,23,33,0,0,5,9,3,17,0,,
692,1,205,88,293,92,22,26,0,0,14,17,1,32,0,,
692,13,174,109,283,74,21,23,0,0,9,6,4,19,0,,
693,5,160,92,252,67,29,6,0,0,13,10,3,26,0,,
693,12,216,125,341,95,29,19,0,0,14,20,3,37,0,,
694,3,164,88,252,61,39,14,0,0,11,6,1,18,0,,
694,14,192,119,311,74,36,18,0,0,9,11,3,23,0,,
695,10,170,94,264,57,32,21,0,0,17,15,2,34,0,,
695,7,189,92,281,72,36,29,0,0,18,18,2,38,0,,
696,18,155,88,243,38,23,35,0,0,9,2,2,13,0,,
696,11,194,80,274,58,42,36,0,0,9,9,2,20,0,,
697,4,200,135,335,75,35,28,0,0,15,6,1,22,0,,
697,13,192,119,311,51,24,28,0,0,7,15,2,24,0,,
698,5,162,112,274,54,32,19,0,0,13,9,4,26,0,,
698,3,186,78,264,55,26,16,0,0,12,7,2,21,0,,
699,9,194,104,298,83,44,19,0,0,13,13,2,28,0,,
700,7,171,124,295,48,30,34,0,0,12,5,0,17,0,,
700,16,174,93,267,64,42,8,0,0,9,10,0,19,0,,
701,14,185,95,280,64,29,20,0,0,13,11,6,30,0,,
701,12,175,108,283,51,33,19,0,0,9,9,4,22,0,,
702,11,176,93,269,58,40,25,0,0,7,12,6,25,0,,
702,1,185,106,291,80,20,18,0,0,16,7,0,23,0,,
703,2,180,97,277,62,22,27,0,0,14,12,1,27,0,,
703,15,184,97,281,64,20,7,0,0,14,10,2,26,0,,
704,10,198,93,291,68,26,17,0,0,20,11,4,35,0,,
704,8,185,107,292,84,30,17,0,0,11,10,1,22,0,,
705,13,171,90,261,58,27,11,0,0,8,12,2,22,0,,
705,7,185,108,293,60,41,24,0,0,17,12,0,29,0,,
706,1,230,99,329,77,24,21,0,0,12,10,4,26,0,,
706,4,185,70,255,63,35,11,0,0,10,6,2,18,0,,
707,12,206,94,300,59,28,26,0,0,11,9,1,21,0,,
707,10,190,76,266,47,41,22,0,0,5,8,3,16,0,,
708,15,215,95,310,44,21,12,0,0,10,14,7,31,0,,
708,8,193,81,274,62,40,33,0,0,6,6,1,13,0,,
709,9,186,75,261,76,25,25,0,0,15,10,2,27,0,,
709,3,195,110,305,71,28,21,0,0,16,8,2,26,0,,
710,16,190,98,288,74,35,26,0,0,9,13,1,23,0,,
710,14,210,112,322,100,32,20,0,0,14,15,1,30,0,,
711,2,204,165,369,76,40,14,0,0,22,12,2,36,0,,
711,18,179,94,273,59,22,23,0,0,8,11,2,21,0,,
712,11,189,96,285,64,37,26,0,0,6,7,5,18,0,,
712,5,175,98,273,60,22,14,0,0,5,7,2,14,0,,
713,4,241,113,354,119,34,23,0,0,18,10,2,30,0,,
713,9,175,87,262,56,29,30,0,0,11,11,4,26,0,,
714,12,191,89,280,72,31,13,0,0,13,9,2,24,0,,
714,2,177,95,272,56,30,18,0,0,13,9,4,26,0,,
715,10,203,87,290,79,23,17,0,0,13,11,1,25,0,,
715,14,220,119,339,106,35,18,0,0,15,8,2,25,0,,
716,13,194,113,307,67,29,16,0,0,18,9,2,29,0,,
716,16,184,104,288,89,23,15,0,0,11,11,2,24,0,,
717,8,180,109,289,83,36,21,0,0,13,9,0,22,0,,
717,1,221,107,328,85,27,19,0,0,15,14,1,30,0,,
718,18,169,89,258,50,24,26,0,0,12,8,4,24,0,,
718,7,214,120,334,70,24,28,0,0,17,11,4,32,0,,
719,5,171,110,281,68,30,23,0,0,18,13,1,32,0,,
719,15,200,103,303,66,20,13,0,0,15,20,1,36,0,,
720,3,180,103,283,66,19,15,0,0,16,5,1,22,0,,
720,11,186,67,253,85,32,21,0,0,14,11,3,28,0,,
721,1,193,123,316,80,30,28,0,0,18,11,0,29,0,,
721,10,181,97,278,67,27,7,0,0,12,8,4,24,0,,
722,11,196,95,291,63,32,41,0,0,14,10,5,29,0,,
722,4,200,84,284,57,20,20,0,0,9,12,0,21,0,,
723,7,220,120,340,69,36,27,0,0,20,14,1,35,0,,
723,9,170,102,272,74,31,13,0,0,13,10,1,24,0,,
724,15,190,81,271,44,32,9,0,0,11,9,4,24,0,,
724,14,188,87,275,63,25,19,0,0,9,5,2,16,0,,
725,11,191,77,268,69,43,34,0,0,11,5,5,21,0,,
725,14,193,116,309,70,25,21,0,0,9,9,5,23,0,,
726,15,185,85,270,57,21,20,0,0,15,8,0,23,0,,
726,4,194,125,319,62,42,11,0,0,12,13,0,25,0,,
727,7,216,93,309,72,32,26,0,0,15,9,5,29,0,,
727,15,199,66,265,46,29,12,0,0,11,6,1,18,0,,
728,11,197,94,291,88,43,21,0,0,12,21,0,33,0,,
728,1,193,109,302,85,17,16,0,0,13,13,0,26,0,,
729,11,172,81,253,68,58,30,0,0,19,7,4,30,0,,
729,7,170,122,292,46,41,16,0,0,13,14,2,29,0,,
730,15,217,88,305,66,20,21,14,15,15,9,4,28,0,,
730,4,198,116,314,74,37,38,16,14,15,7,4,26,0,,
731,5,179,85,264,66,24,20,15,23,18,12,3,33,0,,
731,8,181,94,275,55,37,42,23,15,12,9,3,24,0,,
732,7,181,88,269,72,24,36,17,19,17,6,1,24,0,,
732,14,190,124,314,69,32,26,19,16,13,13,0,26,0,,
733,9,160,82,242,48,24,46,22,23,10,9,3,22,0,,
733,1,196,102,298,69,22,16,23,22,17,12,4,33,0,,
734,12,190,114,304,64,34,29,20,13,10,12,1,23,0,,
734,11,163,71,234,58,28,27,15,21,9,8,1,18,0,,
735,18,172,101,273,58,25,18,17,12,17,10,5,32,0,,
735,10,180,116,296,66,26,15,14,19,20,3,1,24,0,,
736,16,170,96,266,67,15,13,20,10,13,5,1,19,0,,
736,13,163,81,244,61,9,22,10,20,8,12,1,21,0,,
737,2,210,116,326,82,31,32,23,21,14,13,6,33,0,,
737,3,184,92,276,75,31,28,21,22,13,10,1,24,0,,
738,4,205,115,320,87,22,25,18,15,17,11,3,31,0,,
738,5,191,71,262,76,15,17,15,18,8,8,0,16,0,,
739,10,183,115,298,56,28,25,16,13,20,14,1,35,0,,
739,9,194,99,293,77,15,24,13,16,14,9,4,27,0,,
740,13,205,110,315,76,20,35,14,23,19,11,0,30,0,,
740,15,193,88,281,61,39,26,23,13,15,10,0,25,0,,
741,8,215,86,301,96,43,34,28,20,10,7,0,17,0,,
741,18,187,95,282,73,17,26,20,28,17,4,6,27,0,,
742,14,205,100,305,81,26,27,21,22,14,14,1,29,0,,
742,2,168,91,259,70,41,22,22,21,11,11,3,25,0,,
743,3,228,107,335,90,16,28,15,15,28,12,2,42,0,,
743,7,176,94,270,77,30,28,15,15,13,9,6,28,0,,
744,11,208,109,317,82,27,36,18,15,25,14,3,42,0,,
744,16,165,128,293,65,18,15,17,20,11,7,1,19,0,,
745,1,207,82,289,103,17,16,26,22,22,8,0,30,0,,
745,12,184,74,258,68,22,31,22,26,13,5,1,19,0,,
746,18,180,103,283,44,26,31,21,25,10,5,4,19,0,,
746,15,199,80,279,59,43,14,25,21,15,6,2,23,0,,
747,2,174,104,278,57,26,37,24,18,15,13,0,28,0,,
747,8,184,69,253,71,38,22,18,24,15,6,1,22,0,,
748,1,211,95,306,78,27,21,15,12,16,19,4,39,0,,
748,5,167,89,256,74,30,38,12,15,13,7,0,20,0,,
749,16,176,107,283,60,25,39,17,21,10,7,0,17,0,,
749,4,175,109,284,58,17,34,21,17,14,9,1,24,0,,
750,10,208,126,334,76,35,31,19,20,24,11,5,40,0,,
750,14,171,82,253,62,16,22,20,19,7,11,4,22,0,,
751,7,183,105,288,62,40,30,24,16,12,8,2,22,0,,
751,11,171,74,245,39,25,47,16,24,8,10,2,20,0,,
752,9,184,96,280,68,15,35,25,30,12,11,4,27,0,,
752,13,183,105,288,58,11,24,30,25,15,9,1,25,0,,
753,3,193,90,283,64,21,17,11,18,14,15,0,29,0,,
753,12,191,87,278,74,26,33,18,10,14,11,3,28,0,,
754,5,225,113,338,104,24,31,19,17,20,9,4,33,0,,
754,2,193,111,304,57,30,20,17,17,12,13,3,28,0,,
755,8,201,86,287,56,36,23,25,22,18,9,4,31,0,,
755,7,180,88,268,63,32,52,22,25,20,7,2,29,0,,
756,4,189,113,302,69,22,33,23,20,14,11,4,29,0,,
756,10,198,98,296,76,22,49,20,23,18,7,3,28,0,,
757,14,191,105,296,82,38,27,25,28,11,10,3,24,0,,
757,1,189,94,283,74,29,29,28,25,14,9,1,24,0,,
758,15,201,72,273,73,28,31,20,32,21,10,1,32,0,,
758,9,205,106,311,80,25,36,32,20,17,14,4,35,0,,
759,12,190,110,300,75,42,46,16,17,10,9,1,20,0,,
759,13,182,95,277,58,31,24,17,16,10,11,1,22,0,,
760,18,185,119,304,44,56,50,19,27,11,6,1,18,0,,
760,11,201,78,279,38,65,42,27,19,8,12,4,24,0,,
761,16,217,117,334,112,41,38,24,21,14,14,2,30,0,,
761,3,179,105,284,77,33,18,21,24,11,9,1,21,0,,
762,2,208,104,312,73,46,26,24,17,12,10,4,26,0,,
762,4,193,77,270,72,30,32,17,23,10,9,2,21,0,,
763,8,198,98,296,72,47,42,16,19,18,13,3,34,0,,
763,9,171,96,267,58,39,31,19,16,12,10,1,23,0,,
764,16,196,107,303,92,10,33,13,20,16,7,1,24,0,,
764,15,208,66,274,54,22,22,19,12,12,14,1,27,0,,
765,5,202,102,304,73,33,26,19,8,15,14,4,33,0,,
765,3,172,97,269,66,22,24,8,19,12,10,6,28,0,,
766,13,208,114,322,87,32,27,25,16,14,15,3,32,0,,
766,18,186,114,300,48,38,21,16,24,6,15,2,23,0,,
767,11,204,85,289,87,59,36,16,16,12,13,2,27,0,,
767,14,198,110,308,82,34,17,16,16,8,12,1,21,0,,
768,10,191,107,298,66,18,26,17,31,14,14,1,29,0,,
768,1,169,96,265,61,9,13,32,17,12,7,4,23,0,,
769,7,204,88,292,68,53,45,12,19,13,8,2,23,0,,
769,12,191,118,309,55,51,53,19,12,9,9,3,21,0,,
770,9,230,142,372,65,15,21,19,24,13,3,5,21,0,,
770,2,204,114,318,50,14,32,24,19,7,6,3,16,0,,
771,14,189,101,290,74,51,29,17,19,13,10,2,25,0,,
771,8,185,90,275,63,47,48,19,17,10,12,1,23,0,,
772,18,192,105,297,72,36,25,20,15,13,16,2,31,0,,
772,16,195,117,312,97,56,24,15,20,9,3,3,15,0,,
773,1,198,121,319,76,30,35,20,21,13,12,7,32,0,,
773,3,200,90,290,92,34,15,22,20,13,10,1,24,0,,
774,5,198,111,309,87,34,20,8,14,14,11,1,26,0,,
774,12,188,112,300,79,19,34,14,8,9,7,6,22,0,,
775,4,199,100,299,82,31,30,23,18,18,8,3,29,0,,
775,7,181,98,279,53,19,45,18,23,18,13,0,31,0,,
776,10,215,109,324,48,26,33,22,25,8,11,2,21,0,,
776,13,201,86,287,65,13,31,25,22,12,7,1,20,0,,
777,15,182,82,264,61,40,21,19,16,15,14,2,31,0,,
777,11,181,95,276,83,37,52,16,19,15,7,5,27,0,,
778,16,171,124,295,65,29,26,19,23,8,5,4,17,0,,
778,8,207,88,295,86,35,26,24,20,15,9,0,24,0,,
779,5,187,110,297,51,49,40,13,9,12,6,1,19,0,,
779,10,174,101,275,62,30,45,9,13,18,4,3,25,0,,
780,7,204,131,335,71,29,48,22,17,11,15,1,27,0,,
780,9,208,105,313,66,59,34,17,22,15,9,0,24,0,,
781,3,198,115,313,76,35,16,17,24,11,2,2,15,0,,
781,14,197,80,277,79,36,33,24,17,12,4,3,19,0,,
782,12,192,103,295,88,25,31,22,14,11,8,2,21,0,,
782,18,214,75,289,103,24,25,14,22,25,12,3,40,0,,
783,1,213,114,327,92,23,28,16,9,16,15,0,31,0,,
783,15,170,79,249,44,26,28,9,16,12,10,1,23,0,,
784,11,190,118,308,66,52,45,12,18,11,11,2,24,0,,
784,4,175,98,273,67,62,31,18,12,10,8,3,21,0,,
785,2,193,131,324,62,47,32,19,15,13,11,2,26,0,,
785,13,173,88,261,50,36,31,15,19,7,5,2,14,0,,
786,3,220,93,313,99,26,21,13,17,12,11,1,24,0,,
786,9,200,95,295,66,31,29,17,13,8,13,9,30,0,,
787,15,199,114,313,74,30,30,19,14,15,12,3,30,0,,
787,10,199,128,327,84,34,28,14,19,14,9,2,25,0,,
788,7,237,107,344,120,30,25,21,19,10,10,2,22,0,,
788,18,202,90,292,87,37,15,19,21,5,11,4,20,0,,
789,14,186,96,282,64,43,39,17,13,12,4,0,16,0,,
789,16,199,91,290,55,45,37,13,17,6,13,5,24,0,,
790,11,197,96,293,88,51,43,15,12,11,12,1,24,0,,
790,2,213,134,347,88,61,25,12,15,14,6,2,22,0,,
791,8,202,88,290,74,42,34,14,12,14,9,3,26,0,,
791,1,217,135,352,110,34,26,12,14,21,8,2,31,0,,
792,13,208,99,307,81,20,29,8,10,17,12,0,29,0,,
792,5,182,138,320,64,32,36,10,8,16,13,2,31,0,,
793,4,199,122,321,71,29,32,20,22,12,19,1,32,0,,
793,12,201,96,297,78,18,33,23,20,12,10,2,24,0,,
794,16,189,97,286,61,30,37,22,19,14,18,3,35,0,,
794,7,184,121,305,67,34,27,19,22,13,6,6,25,0,,
795,14,145,98,243,36,37,40,18,10,5,8,6,19,0,,
795,4,163,103,266,56,48,43,10,18,9,8,3,20,0,,
796,12,196,122,318,77,18,48,17,19,10,14,0,24,0,,
796,15,174,77,251,59,28,27,19,17,17,10,3,30,0,,
797,13,176,72,248,64,30,40,11,12,12,11,1,24,0,,
797,3,198,116,314,93,32,31,12,11,18,13,1,32,0,,
798,9,200,110,310,83,18,12,12,13,6,13,1,20,0,,
798,11,194,86,280,66,22,29,13,12,14,10,4,28,0,,
799,1,191,135,326,91,26,36,13,14,13,7,3,23,0,,
799,2,170,118,288,60,42,25,14,12,11,6,3,20,0,,
800,10,223,102,325,100,22,20,13,13,17,12,3,32,0,,
800,8,169,86,255,70,10,29,13,13,11,8,6,25,0,,
801,18,204,114,318,100,41,37,10,18,11,13,1,25,0,,
801,5,176,131,307,62,38,35,18,10,9,9,0,18,0,,
802,4,194,108,302,87,23,38,16,17,16,14,3,33,0,,
802,1,171,105,276,70,12,38,17,16,15,7,3,25,0,,
803,12,197,135,332,84,35,37,14,21,17,8,1,26,0,,
803,9,185,127,312,75,45,25,21,14,12,12,3,27,0,,
804,10,160,88,248,60,28,31,15,10,8,4,1,13,0,,
804,7,210,132,342,74,15,36,10,15,24,9,1,34,0,,
805,2,213,173,386,94,33,30,16,13,13,16,3,32,0,,
805,18,169,109,278,70,19,29,13,16,9,10,3,22,0,,
806,8,219,95,314,86,45,32,22,17,13,9,0,22,0,,
806,3,215,123,338,93,24,21,17,22,13,14,1,28,0,,
807,5,157,102,259,58,48,31,17,18,19,4,1,24,0,,
807,16,185,90,275,52,30,56,18,17,17,7,3,27,0,,
808,11,202,103,305,84,48,41,25,11,17,7,2,26,0,,
808,13,197,89,286,99,35,27,11,25,8,9,1,18,0,,
809,15,176,77,253,63,22,24,16,10,13,11,2,26,0,,
809,14,198,103,301,90,37,31,10,16,17,9,3,29,0,,
810,3,229,115,344,112,31,31,15,14,24,14,2,40,0,,
810,10,195,103,298,87,24,24,14,15,15,8,2,25,0,,
811,18,177,116,293,59,40,41,15,25,7,10,3,20,0,,
811,4,184,102,286,81,39,23,25,15,8,8,1,17,0,,
812,8,232,111,343,98,43,35,25,15,10,8,2,20,0,,
812,13,197,71,268,76,34,28,15,25,18,6,3,27,0,,
813,14,211,114,325,79,42,34,28,19,12,5,3,20,0,,
813,12,187,136,323,34,32,23,19,28,9,7,2,18,0,,
814,16,211,135,346,87,23,46,22,19,17,14,5,36,0,,
814,9,194,111,305,59,37,31,19,22,7,6,2,15,0,,
815,1,188,149,337,69,27,29,19,19,24,10,1,35,0,,
815,11,153,85,238,33,30,46,19,19,13,7,3,23,0,,
816,7,188,137,325,72,37,41,22,21,21,8,3,32,0,,
816,2,172,124,296,53,50,36,21,22,16,12,2,30,0,,
817,15,187,86,273,66,25,33,14,10,19,9,3,31,0,,
817,5,178,113,291,80,22,39,10,14,13,14,5,32,0,,
818,4,189,87,276,68,39,39,16,15,19,7,2,28,0,,
818,8,211,121,332,65,31,49,15,16,17,5,1,23,0,,
819,12,219,141,360,99,25,49,17,18,14,14,2,30,0,,
819,10,197,90,287,98,31,23,18,17,11,8,0,19,0,,
820,11,181,93,274,58,37,35,16,15,15,16,2,33,0,,
820,3,203,112,315,92,27,32,15,16,15,15,1,31,0,,
821,13,170,132,302,70,43,39,9,11,7,4,0,11,0,,
821,14,204,130,334,76,37,24,11,9,22,7,2,31,0,,
822,1,186,174,360,61,24,30,23,16,18,10,4,32,0,,
822,16,188,118,306,87,31,24,16,23,15,2,4,21,0,,
823,9,182,121,303,69,22,31,29,20,18,12,3,33,0,,
824,2,197,128,325,75,41,46,10,13,19,10,3,32,0,,
824,15,165,76,241,50,33,29,13,10,14,8,0,22,0,,
825,7,205,111,316,77,37,34,21,11,17,9,6,32,0,,
825,5,183,125,308,65,38,32,11,21,11,13,3,27,0,,
826,3,203,110,313,90,24,31,19,17,11,5,1,17,0,,
826,4,213,126,339,88,23,22,17,19,11,12,5,28,0,,
827,8,224,122,346,71,35,45,22,17,17,10,2,29,0,,
827,15,177,87,264,54,29,29,17,22,17,5,5,27,0,,
828,14,172,97,269,72,29,27,22,19,12,6,2,20,0,,
828,9,207,125,332,86,20,21,19,22,15,10,6,31,0,,
829,18,210,100,310,77,37,30,16,29,11,6,1,18,0,,
829,1,179,126,305,57,30,30,29,16,5,8,1,14,0,,
830,5,171,95,266,63,46,37,13,10,10,7,3,20,0,,
830,11,196,115,311,74,30,33,10,13,11,8,5,24,0,,
831,13,166,77,243,67,21,44,16,15,5,9,3,17,0,,
831,7,225,109,334,89,55,39,15,16,19,13,0,32,0,,
832,10,181,132,313,67,27,17,18,17,16,6,0,22,0,,
832,2,171,94,265,72,15,32,17,18,13,9,4,26,0,,
833,16,205,147,352,90,24,31,25,21,10,11,5,26,0,,
833,12,185,124,309,63,18,42,21,25,10,5,3,18,0,,
834,15,197,76,273,64,34,26,18,13,19,10,3,32,0,,
834,3,222,111,333,105,29,28,13,18,16,12,1,29,0,,
835,12,195,128,323,78,18,36,15,13,13,12,2,27,0,,
835,8,169,88,257,49,54,41,13,15,11,9,1,21,0,,
836,18,196,113,309,64,40,37,18,25,13,11,2,26,0,,
836,14,157,88,245,40,30,35,25,18,10,10,3,23,0,,
837,2,210,142,352,79,38,31,18,16,23,5,2,30,0,,
837,16,186,117,303,78,22,34,16,18,8,4,3,15,0,,
838,7,195,119,314,84,36,25,18,12,12,9,6,27,0,,
838,1,195,127,322,86,30,27,12,18,10,10,2,22,0,,
839,4,192,118,310,91,33,27,21,10,11,9,4,24,0,,
839,13,200,132,332,65,23,51,10,21,14,10,2,26,0,,
840,9,223,144,367,107,19,27,13,19,19,17,4,40,0,,
840,5,179,128,307,67,12,34,19,13,12,9,2,23,0,,
841,10,180,131,311,66,22,22,18,8,12,13,2,27,0,,
841,11,190,98,288,73,17,43,8,18,18,13,3,34,0,,
842,2,202,119,321,69,50,31,27,8,20,10,2,32,0,,
842,12,194,122,316,88,18,48,8,27,11,3,1,15,0,,
843,1,183,128,311,73,38,36,27,16,12,7,4,23,0,,
843,13,146,125,271,50,45,36,16,27,9,8,3,20,0,,
844,3,212,129,341,96,28,22,15,24,16,9,3,28,0,,
844,18,165,87,252,74,32,35,24,15,12,5,4,21,0,,
845,9,188,112,300,56,22,36,21,26,6,11,2,19,0,,
845,4,216,97,313,86,26,39,26,21,11,8,2,21,0,,
846,7,168,96,264,62,38,44,20,17,12,5,2,19,0,,
846,15,188,109,297,55,41,35,17,20,22,12,1,35,0,,
847,16,182,103,285,69,14,47,23,19,10,4,5,19,0,,
847,10,185,94,279,67,32,29,19,23,13,3,1,17,0,,
848,5,166,96,262,46,48,45,18,15,10,8,3,21,0,,
848,14,171,132,303,63,22,29,15,18,9,4,3,16,0,,
849,11,199,96,295,38,41,49,26,28,9,9,5,23,0,,
849,8,206,69,275,28,38,52,28,26,4,7,4,15,0,,
850,11,170,80,250,65,45,48,14,16,16,4,1,21,0,,
850,12,197,152,349,80,40,43,16,14,16,8,1,25,0,,
851,14,189,129,318,85,25,23,13,9,10,13,3,26,0,,
851,7,190,117,307,81,35,30,9,13,15,9,1,25,0,,
852,1,214,170,384,106,24,29,19,11,27,13,2,42,0,,
852,9,168,112,280,78,34,19,11,19,13,8,0,21,0,,
853,13,188,137,325,70,27,35,17,22,16,9,1,26,0,,
853,16,170,112,282,69,38,29,22,17,13,5,0,18,0,,
854,8,173,73,246,70,21,37,13,8,4,10,4,18,0,,
854,5,230,126,356,113,28,30,8,13,19,8,2,29,0,,
855,3,199,114,313,100,24,27,17,16,14,8,2,24,0,,
855,2,184,110,294,82,23,24,16,17,10,11,4,25,0,,
856,10,188,121,309,75,15,11,11,16,18,9,1,28,0,,
856,18,173,88,261,83,12,38,16,11,12,11,1,24,0,,
857,4,203,126,329,76,25,26,18,17,11,11,3,25,0,,
857,15,196,74,270,57,22,32,17,18,13,10,6,29,0,,
858,16,185,105,290,57,24,37,22,19,14,10,4,28,0,,
858,11,181,94,275,63,19,42,19,22,15,5,2,22,0,,
859,5,202,114,316,79,30,41,23,17,9,10,1,20,0,,
859,4,206,134,340,84,54,30,17,23,13,5,3,21,0,,
860,12,205,148,353,90,31,29,24,28,29,7,4,40,0,,
860,1,170,94,264,71,38,27,28,24,15,12,3,30,0,,
861,15,220,95,315,79,44,33,11,12,22,17,3,42,0,,
861,13,185,95,280,90,26,42,12,11,13,9,0,22,0,,
862,18,180,88,268,52,25,45,18,17,18,9,2,29,0,,
862,8,187,99,286,66,33,26,17,18,15,7,1,23,0,,
863,9,173,110,283,62,23,42,13,16,14,4,1,19,0,,
863,10,199,116,315,79,13,33,16,13,22,13,4,39,0,,
864,2,192,97,289,75,43,30,22,22,10,7,0,17,0,,
864,14,184,102,286,82,29,28,22,22,8,5,5,18,0,,
865,7,208,88,296,77,39,44,25,19,13,6,3,22,0,,
865,3,196,99,295,71,44,34,19,25,14,3,3,20,0,,
866,5,162,83,245,55,42,37,28,19,10,5,2,17,0,,
866,1,202,115,317,64,36,34,19,28,16,11,3,30,0,,
867,13,206,138,344,78,22,35,19,26,22,16,3,41,0,,
867,9,184,114,298,77,43,32,26,19,8,7,1,16,0,,
868,14,176,123,299,78,18,29,29,13,12,11,4,27,0,,
868,10,178,127,305,75,48,28,13,29,19,6,1,26,0,,
869,11,217,118,335,80,29,55,21,12,19,22,1,42,0,,
869,7,160,98,258,62,29,31,12,21,10,6,1,17,0,,
870,15,238,118,356,83,27,27,18,20,18,20,3,41,0,,
870,18,194,92,286,92,24,26,20,18,10,13,3,26,0,,
871,8,225,134,359,88,52,36,25,23,10,7,3,20,0,,
871,2,180,119,299,100,31,31,23,25,4,9,1,14,0,,
872,4,209,94,303,76,37,27,19,20,15,8,1,24,0,,
872,16,186,110,296,70,19,35,20,19,8,10,2,20,0,,
873,3,192,114,306,74,28,22,19,26,12,8,4,24,0,,
873,12,211,115,326,91,29,40,26,19,11,12,0,23,0,,
874,9,199,125,324,72,35,33,21,20,12,8,6,26,0,,
874,15,201,85,286,64,24,27,20,21,15,16,7,38,0,,
875,1,190,109,299,78,39,20,26,15,13,15,3,31,0,,
875,14,175,97,272,73,37,35,15,26,14,8,5,27,0,,
876,7,186,134,320,85,29,28,20,14,10,9,0,19,0,,
876,8,204,119,323,73,35,38,14,20,19,13,1,33,0,,
877,16,184,90,274,75,24,25,16,20,12,12,2,26,0,,
877,3,207,125,332,76,21,35,20,16,18,9,2,29,0,,
878,13,174,109,283,72,33,29,14,16,16,15,2,33,0,,
878,12,178,109,287,83,35,36,16,14,8,11,5,24,0,,
879,10,211,132,343,78,21,28,24,21,10,12,2,24,0,,
879,4,173,95,268,69,13,25,21,24,9,8,6,23,0,,
880,11,226,102,328,105,34,32,25,18,22,9,3,34,0,,
880,18,174,82,256,69,34,34,18,25,10,9,1,20,0,,
881,2,199,147,346,94,30,26,15,24,12,9,5,26,0,,
881,5,182,109,291,81,28,29,24,15,9,12,1,22,0,,
882,15,223,126,349,60,41,31,21,24,22,16,3,41,0,,
882,16,182,61,243,70,18,35,24,21,7,5,0,12,0,,
883,9,200,117,317,91,8,14,11,13,7,14,3,24,0,,
883,8,193,128,321,79,18,18,13,11,13,12,4,29,0,,
884,3,207,112,319,78,27,28,22,22,16,8,5,29,0,,
884,5,201,89,290,88,21,32,22,22,14,12,3,29,0,,
885,14,161,97,258,61,26,40,22,19,6,7,1,14,0,,
885,11,185,102,287,71,36,38,19,22,18,10,0,28,0,,
886,1,188,135,323,68,25,26,22,17,15,8,1,24,0,,
886,10,175,119,294,58,39,39,17,22,15,4,3,22,0,,
887,4,211,105,316,85,20,21,17,23,16,13,3,32,0,,
887,2,177,111,288,53,23,32,23,17,11,3,4,18,0,,
888,18,182,107,289,68,36,28,22,22,10,11,0,21,0,,
888,13,181,135,316,64,20,34,22,22,14,10,0,24,0,,
889,12,219,131,350,91,33,44,24,20,19,13,7,39,0,,
889,7,176,119,295,73,40,29,20,24,15,11,3,29,0,,
890,3,183,107,290,72,29,37,25,30,13,10,2,25,0,,
890,1,200,92,292,76,28,13,30,25,14,13,4,31,0,,
891,7,198,126,324,54,49,47,22,16,9,7,2,18,0,,
891,4,195,80,275,45,49,41,16,22,7,10,3,20,0,,
892,2,221,161,382,95,40,30,19,19,24,10,1,35,0,,
892,9,194,133,327,70,30,24,19,19,11,10,2,23,0,,
893,11,193,99,292,59,37,47,22,12,13,12,2,27,0,,
893,15,195,92,287,39,42,31,12,22,14,18,3,35,0,,
894,16,172,102,274,64,19,39,21,19,10,10,1,21,0,,
894,18,177,101,278,54,18,36,19,21,19,9,1,29,0,,
895,8,212,116,328,83,52,35,16,13,11,15,3,29,0,,
895,14,226,103,329,120,14,20,13,16,8,9,6,23,0,,
896,5,180,136,316,67,20,22,19,15,8,12,3,23,0,,
896,12,211,160,371,81,32,29,15,19,17,12,4,33,0,,
897,13,183,127,310,72,23,39,11,31,17,5,7,29,0,,
897,10,210,99,309,87,34,24,31,11,12,10,1,23,0,,
898,15,183,95,278,55,39,28,23,26,17,7,4,28,0,,
898,1,193,102,295,78,36,29,26,23,16,10,2,28,0,,
899,3,181,129,310,67,21,31,14,12,18,7,2,27,0,,
899,14,231,80,311,128,28,18,12,14,19,9,4,32,0,,
900,9,204,93,297,89,25,34,19,23,12,18,2,32,0,,
900,7,182,115,297,73,24,21,23,19,13,12,1,26,0,,
901,8,217,157,374,74,43,42,24,13,22,13,4,39,0,,
901,16,185,105,290,76,48,20,13,24,9,5,1,15,0,,
902,4,186,107,293,69,29,27,25,18,12,4,5,21,0,,
902,11,202,132,334,69,21,42,18,25,15,15,1,31,0,,
903,13,185,106,291,86,24,32,27,20,19,15,4,38,0,,
903,2,164,131,295,72,34,26,20,27,8,9,0,17,0,,
904,10,210,122,332,79,9,30,16,13,18,8,3,29,0,,
904,5,221,145,366,117,10,19,13,16,16,11,0,27,0,,
905,18,178,111,289,64,38,38,18,20,12,10,2,24,0,,
905,12,235,165,400,114,17,28,20,18,21,12,0,33,0,,
906,15,207,83,290,53,38,29,19,16,11,15,1,27,0,,
906,3,206,93,299,77,33,32,16,19,8,10,2,20,0,,
907,13,180,109,289,71,35,40,17,18,17,12,1,30,0,,
907,11,154,109,263,48,41,40,18,17,9,9,4,22,0,,
908,10,195,94,289,59,28,28,24,20,12,13,4,29,0,,
908,7,158,86,244,40,18,36,20,24,13,8,1,22,0,,
909,1,215,128,343,84,36,22,20,20,18,10,3,31,0,,
909,4,166,108,274,76,37,27,20,20,7,6,3,16,0,,
910,11,168,71,239,31,16,31,13,26,14,8,2,24,0,,
910,10,219,85,304,50,24,23,26,13,10,3,4,17,0,,
911,13,201,102,303,77,39,31,20,27,15,15,2,32,0,,
911,7,180,112,292,69,53,33,27,20,7,11,3,21,0,,
912,15,208,82,290,77,44,42,21,23,17,11,1,29,0,,
912,13,181,89,270,52,22,35,23,21,12,10,2,24,0,,
913,11,192,100,292,74,41,37,15,7,24,14,3,41,0,,
913,1,193,117,310,72,30,29,7,15,13,9,6,28,0,,
914,11,185,108,293,79,29,40,16,17,15,14,1,30,0,,
914,15,189,80,269,59,25,24,17,16,8,19,3,30,0,,
915,3,201,138,339,76,14,16,31,24,16,9,5,30,0,,
915,12,208,118,326,99,10,26,24,31,9,14,3,26,0,,
916,15,206,84,290,72,15,32,14,14,21,8,1,30,0,,
916,14,210,109,319,86,17,34,14,14,22,8,1,31,0,,
917,13,185,101,286,62,14,23,22,18,14,19,1,34,0,,
917,2,174,84,258,76,22,29,18,22,13,9,0,22,0,,
918,11,174,98,272,70,21,29,18,21,12,4,2,18,0,,
918,1,193,126,319,64,14,22,21,18,13,12,1,26,0,,
919,9,204,114,318,84,12,29,19,25,23,11,3,37,0,,
919,7,177,96,273,80,6,10,25,19,10,3,0,13,0,,
920,16,184,104,288,62,12,18,23,19,13,16,4,33,0,,
920,4,164,124,288,61,16,15,19,23,15,10,2,27,0,,
921,5,181,119,300,76,18,23,20,26,8,8,3,19,0,,
921,8,193,87,280,71,25,39,26,20,10,10,4,24,0,,
922,10,186,83,269,65,24,15,24,24,12,12,2,26,0,,
922,18,184,87,271,63,17,26,24,24,17,8,5,30,0,,
923,15,220,102,322,85,24,24,17,14,15,12,4,31,0,,
923,3,197,102,299,66,31,29,14,17,22,6,3,31,0,,
924,4,189,123,312,70,15,16,14,16,11,16,1,28,0,,
924,9,172,108,280,67,19,35,16,14,11,5,2,18,0,,
925,2,198,95,293,71,20,15,20,24,15,12,6,33,0,,
925,10,207,103,310,94,10,21,24,20,13,11,7,31,0,,
926,1,193,120,313,83,18,20,21,25,20,11,3,34,0,,
926,14,221,87,308,98,17,32,25,21,24,8,3,35,0,,
927,8,193,81,274,57,20,27,21,23,8,7,1,16,0,,
927,11,194,77,271,77,18,27,23,21,8,7,5,20,0,,
928,7,230,124,354,126,25,48,16,17,19,13,3,35,0,,
928,13,180,95,275,49,26,17,17,16,13,5,1,19,0,,
929,18,186,89,275,69,17,38,14,14,17,11,1,29,0,,
929,16,206,86,292,88,15,23,14,14,15,6,5,26,0,,
930,5,183,137,320,65,20,19,25,19,12,7,4,23,0,,
930,12,217,149,366,76,29,42,19,25,15,16,6,37,0,,
931,2,211,130,341,66,20,36,19,13,13,7,5,25,0,,
931,15,206,111,317,77,30,35,13,24,15,9,1,25,0,,
932,14,233,91,324,109,28,29,17,19,14,11,2,27,0,,
932,13,179,111,290,75,21,31,19,17,12,18,1,31,0,,
933,16,201,128,329,77,27,29,25,23,11,7,5,23,0,,
933,8,219,129,348,58,26,37,23,25,16,12,4,32,0,,
934,3,227,149,376,90,22,15,19,12,22,17,0,39,0,,
934,10,201,104,305,100,18,27,12,19,9,10,4,23,0,,
935,9,170,112,282,66,25,27,17,18,11,10,4,25,0,,
935,18,200,66,266,83,11,23,18,17,15,9,4,28,0,,
936,5,180,113,293,65,27,28,15,20,11,8,1,20,0,,
936,4,214,109,323,90,16,27,20,15,16,14,1,31,0,,
937,11,175,86,261,72,29,30,20,24,14,11,1,26,0,,
937,7,197,106,303,75,25,33,24,20,11,14,1,26,0,,
938,1,175,95,270,68,28,27,22,24,15,11,2,28,0,,
938,12,194,89,283,89,28,29,24,22,15,11,4,30,0,,
939,13,217,108,325,80,32,24,23,20,12,10,3,25,0,,
939,8,196,104,300,55,33,36,20,23,12,9,3,24,0,,
940,5,170,113,283,55,17,30,20,19,14,8,4,26,0,,
940,2,190,130,320,74,29,36,19,20,22,11,3,36,0,,
941,12,215,107,322,89,23,36,15,23,19,5,2,26,0,,
941,16,191,97,288,73,23,39,23,15,14,5,3,22,0,,
942,10,193,109,302,62,27,19,15,13,10,9,3,22,0,,
942,15,193,74,267,67,19,36,13,15,10,9,1,20,0,,
943,7,195,115,310,88,21,20,12,22,16,8,3,27,0,,
943,1,201,100,301,87,17,24,22,12,15,7,2,24,0,,
944,9,214,108,322,51,30,50,15,16,17,9,4,30,0,,
944,11,165,71,236,26,24,28,16,15,8,3,3,14,0,,
945,18,204,95,299,88,21,49,18,11,10,12,2,24,0,,
945,14,213,114,327,115,28,28,11,18,17,10,3,30,0,,
946,4,220,123,343,91,25,31,32,23,15,5,2,22,0,,
946,3,171,100,271,57,24,24,23,32,3,5,0,8,0,,
947,2,180,116,296,80,31,35,13,15,12,5,4,21,0,,
947,1,208,111,319,85,23,35,18,19,21,13,4,38,0,,
948,15,209,62,271,71,26,29,20,10,14,6,2,22,0,,
948,7,221,115,336,93,10,30,19,16,13,9,3,25,0,,
949,13,173,118,291,67,19,33,13,24,13,6,6,25,0,,
949,18,192,78,270,90,19,39,24,13,9,7,5,21,0,,
950,8,199,107,306,60,30,33,20,13,9,13,1,23,0,,
950,4,209,110,319,86,25,24,13,20,14,8,2,24,0,,
951,12,191,107,298,71,25,36,18,19,9,7,4,20,0,,
951,14,190,100,290,73,35,27,14,11,17,9,4,30,0,,
952,16,172,108,280,79,19,20,13,12,7,7,4,18,0,,
952,9,198,139,337,72,16,44,12,13,15,15,3,33,0,,
953,11,198,112,310,73,11,36,12,10,23,16,1,40,0,,
953,10,175,147,322,78,24,13,10,12,11,7,1,19,0,,
954,3,200,100,300,89,17,41,12,14,15,15,3,33,0,,
954,5,195,92,287,88,21,18,14,12,15,9,1,25,0,,
955,7,224,119,343,96,25,36,23,21,14,12,3,29,0,,
955,12,185,100,285,68,30,25,21,23,7,13,3,23,0,,
956,14,200,92,292,80,27,36,23,29,14,11,3,28,0,,
956,8,214,98,312,89,24,35,29,23,14,14,2,30,0,,
957,9,205,127,332,72,31,44,22,14,14,6,3,23,0,,
957,13,174,102,276,55,27,27,14,22,10,8,2,20,0,,
958,4,194,128,322,80,28,27,21,19,18,14,2,34,0,,
958,1,168,91,259,70,14,23,19,21,7,9,1,17,0,,
959,2,182,96,278,64,26,27,20,18,11,11,1,23,0,,
959,3,201,105,306,84,28,23,18,20,17,7,4,28,0,,
960,5,218,140,358,85,15,23,15,10,16,9,4,29,0,,
960,15,213,77,290,69,25,43,10,15,21,10,1,32,0,,
961,11,180,125,305,65,27,28,19,16,18,6,1,25,0,,
961,18,193,101,294,57,31,41,16,19,12,14,1,27,0,,
962,10,182,135,317,79,19,15,18,16,15,9,1,25,0,,
962,16,182,128,310,72,14,22,16,18,11,7,2,20,0,,
963,2,172,108,280,58,24,26,27,21,14,11,3,28,0,,
963,12,186,106,292,71,25,30,21,27,18,9,1,28,0,,
964,7,227,105,332,103,23,34,17,19,9,12,2,23,0,,
964,4,193,100,293,86,28,28,19,17,7,4,2,13,0,,
965,18,144,83,227,58,17,25,20,11,10,11,4,25,0,,
965,1,201,115,316,95,18,41,11,20,18,10,2,30,0,,
966,13,187,77,264,72,27,44,21,13,20,14,0,34,0,,
966,3,183,94,277,75,23,14,13,21,17,7,4,28,0,,
967,9,227,84,311,87,29,39,16,22,13,14,4,31,0,,
967,5,187,101,288,64,13,15,21,14,9,6,2,17,0,,
968,16,221,127,348,107,26,31,21,22,16,19,1,36,0,,
968,14,187,95,282,73,29,26,22,21,15,9,0,24,0,,
969,10,171,113,284,66,20,15,18,17,20,9,2,31,0,,
969,8,154,88,242,67,17,34,17,18,16,5,2,23,0,,
970,15,191,76,267,77,25,41,21,20,22,8,1,31,0,,
970,11,172,86,258,73,18,21,20,21,12,7,6,25,0,,
971,3,168,104,272,54,32,15,22,19,7,6,3,16,0,,
971,7,191,99,290,63,14,44,19,22,13,15,1,29,0,,
972,8,212,68,280,58,13,39,20,14,7,6,1,14,0,,
972,15,243,73,316,82,14,32,14,20,15,7,4,26,0,,
973,1,225,105,330,67,24,34,31,23,17,14,1,32,0,,
973,13,170,100,270,39,24,30,23,31,7,10,1,18,0,,
974,5,193,81,274,49,30,39,29,18,14,8,7,29,0,,
974,16,183,97,280,75,33,34,18,29,8,10,1,19,0,,
975,18,201,110,311,84,26,37,24,17,19,6,5,30,0,,
975,12,173,110,283,49,19,40,17,24,13,7,1,21,0,,
976,2,200,93,293,86,19,25,27,18,21,7,2,30,0,,
976,9,171,88,259,64,28,37,18,27,17,13,4,34,0,,
977,14,190,104,294,87,19,45,12,12,14,14,2,30,0,,
977,10,184,135,319,83,16,33,12,12,21,12,3,36,0,,
978,4,203,148,351,71,27,25,18,14,19,11,1,31,0,,
978,11,163,102,265,64,24,41,14,18,11,4,2,17,0,,
979,5,173,109,282,72,33,23,15,21,12,14,2,28,0,,
979,1,206,124,330,105,25,29,21,15,19,7,5,31,0,,
980,16,191,140,331,81,18,23,20,16,12,13,1,26,0,,
980,15,211,90,301,74,22,30,16,20,17,14,0,31,0,,
981,12,214,136,350,100,24,30,22,20,15,4,3,22,0,,
981,13,162,100,262,56,27,39,20,22,9,10,0,19,0,,
982,11,181,86,267,37,18,42,19,20,9,11,2,22,0,,
982,2,193,76,269,37,23,39,20,19,12,6,0,18,0,,
983,8,186,116,302,75,29,34,23,17,7,4,1,12,0,,
983,3,225,114,339,89,28,27,17,23,15,15,2,32,0,,
984,10,191,138,329,70,15,21,18,21,11,10,5,26,0,,
984,4,215,83,298,105,13,33,21,18,14,9,1,24,0,,
985,7,206,120,326,106,18,32,15,14,18,11,0,29,0,,
985,18,172,80,252,73,33,27,14,15,7,13,2,22,0,,
986,9,226,103,329,99,32,31,19,27,22,12,0,34,0,,
986,14,196,102,298,83,25,24,27,19,11,15,6,32,0,,
987,11,174,73,247,48,13,34,29,21,8,8,5,21,0,,
987,3,212,104,316,59,26,22,21,29,16,10,3,29,0,,
988,13,175,96,271,69,30,31,19,23,13,11,1,25,0,,
988,16,218,97,315,87,21,28,23,19,22,10,2,34,0,,
989,14,202,101,303,88,38,25,29,24,16,10,2,28,0,,
989,7,226,119,345,103,26,40,24,29,18,8,2,28,0,,
990,2,205,90,295,82,21,24,22,18,11,13,2,26,0,,
990,8,193,84,277,76,32,38,18,22,12,15,0,27,0,,
991,9,178,65,243,42,31,34,30,24,6,6,2,14,0,,
991,1,201,83,284,38,21,35,24,30,9,8,4,21,0,,
992,15,203,79,282,75,20,31,16,7,20,11,2,33,0,,
992,18,196,119,315,85,13,24,7,16,18,17,1,36,0,,
993,10,219,151,370,105,32,30,10,16,22,7,6,35,0,,
993,5,183,139,322,71,23,31,16,10,14,7,3,24,0,,
994,4,181,111,292,68,30,32,18,15,12,11,1,24,0,,
994,12,204,125,329,96,22,39,15,18,15,8,3,26,0,,
995,3,207,117,324,91,27,27,14,20,21,10,1,32,0,,
995,14,201,108,309,91,14,30,20,14,15,12,2,29,0,,
996,7,173,131,304,75,21,45,11,20,10,11,2,23,0,,
996,10,214,90,304,114,34,17,20,11,15,11,1,27,0,,
997,18,199,76,275,46,39,45,23,20,4,6,2,12,0,,
997,2,192,83,275,35,26,35,20,23,3,6,6,15,0,,
998,12,177,160,337,70,23,32,18,14,12,3,3,18,0,,
998,9,198,85,283,90,36,38,14,18,13,11,5,29,0,,
999,1,196,90,286,81,20,36,21,16,10,15,1,26,0,,
1000,16,228,136,364,101,34,32,18,19,18,13,1,32,0,,
1000,11,150,105,255,54,24,27,19,18,12,8,3,23,0,,
1001,15,205,97,302,58,23,36,27,22,12,10,2,24,0,,
1001,4,192,119,311,73,12,19,22,27,9,8,2,19,0,,
1002,5,185,84,269,81,33,30,21,14,11,12,0,23,0,,
1002,13,163,103,266,56,25,44,14,21,13,7,4,24,0,,
1003,2,203,97,300,68,37,42,19,17,15,9,2,26,0,,
1003,14,184,102,286,68,27,31,17,19,9,8,4,21,0,,
1004,8,165,87,252,65,34,46,19,13,17,6,1,24,0,,
1004,7,174,116,290,71,15,34,13,19,14,9,3,26,0,,
1005,1,211,121,332,101,18,18,23,20,17,10,3,30,0,,
1005,16,185,104,289,95,26,16,20,23,11,8,5,24,0,,
1006,11,207,111,318,77,13,42,17,9,14,11,4,29,0,,
1006,5,197,132,329,82,22,26,9,17,14,9,1,24,0,,
1007,9,175,73,248,67,22,46,14,18,9,14,3,26,0,,
1007,3,189,93,282,75,23,24,18,14,13,9,2,24,0,,
1008,13,185,108,293,63,35,36,15,23,14,6,2,22,0,,
1008,15,185,84,269,69,39,25,23,15,12,15,6,33,0,,
1009,12,188,130,318,84,27,37,21,17,8,12,1,21,0,,
1009,10,200,130,330,84,33,23,17,21,12,13,3,28,0,,
1010,4,196,125,321,87,22,32,18,23,21,8,3,32,0,,
1010,18,152,103,255,58,18,42,23,18,11,5,1,17,0,,
1011,3,193,109,302,66,31,35,30,22,10,9,11,30,0,,
1011,1,200,118,318,93,28,28,22,30,11,8,2,21,0,,
1012,14,187,127,314,90,18,21,17,11,9,10,4,23,0,,
1012,4,207,114,321,102,26,21,11,17,16,14,2,32,0,,
1013,18,188,102,290,63,16,30,22,16,8,13,4,25,0,,
1013,8,181,88,269,64,21,16,16,22,6,8,1,15,0,,
1014,7,210,124,334,95,26,31,12,18,11,13,3,27,0,,
1014,5,200,108,308,94,16,31,18,12,15,8,5,28,0,,
1015,15,202,72,274,62,28,43,17,17,13,9,2,24,0,,
1015,12,190,128,318,67,24,51,17,17,8,4,1,13,0,,
1016,10,193,103,296,68,23,30,16,15,15,7,1,23,0,,
1016,9,207,96,303,102,19,31,15,16,20,11,2,33,0,,
1017,16,194,131,325,74,26,28,16,18,19,8,4,31,0,,
1017,2,185,94,279,74,21,33,18,16,19,10,3,32,0,,
1018,13,172,109,281,65,32,32,9,18,16,11,2,29,0,,
1018,11,194,124,318,83,27,27,18,9,13,7,6,26,0,,
1019,5,205,117,322,87,27,26,20,18,13,8,1,22,0,,
1019,18,182,107,289,58,14,35,18,20,12,10,6,28,0,,
1020,15,188,88,276,70,20,39,15,18,15,11,1,27,0,,
1020,9,187,119,306,77,22,24,18,15,15,7,3,25,0,,
1021,7,191,103,294,77,19,34,24,20,13,13,5,31,0,,
1021,2,172,80,252,71,25,23,20,24,8,4,3,15,0,,
1022,4,202,94,296,91,31,18,24,14,16,14,2,32,0,,
1022,13,168,107,275,59,18,41,14,24,11,11,0,22,0,,
1023,3,198,118,316,79,24,24,20,17,16,10,2,28,0,,
1023,16,213,122,335,97,18,27,17,20,10,10,2,22,0,,
1024,11,212,117,329,97,16,31,15,16,25,5,4,34,0,,
1024,14,191,105,296,103,20,20,16,15,14,9,3,26,0,,
1025,10,180,89,269,87,22,17,15,15,14,12,5,31,0,,
1025,1,196,115,311,83,12,23,15,15,18,11,4,33,0,,
1026,8,205,95,300,81,27,31,22,13,7,8,5,20,0,,
1026,12,205,120,325,96,15,28,13,22,13,10,1,24,0,,
1027,2,193,136,329,70,27,37,11,13,16,7,1,24,0,,
1027,4,192,103,295,65,29,25,13,11,11,8,1,20,0,,
1028,13,166,111,277,59,22,41,16,21,10,12,2,24,0,,
1028,10,245,127,372,129,28,17,21,16,18,13,4,35,0,,
1029,16,210,135,345,81,25,30,29,16,16,7,4,27,0,,
1029,7,186,123,309,85,25,29,16,29,12,8,4,24,0,,
1030,9,216,94,310,75,28,33,16,26,13,13,1,27,0,,
1030,8,203,103,306,63,30,23,26,16,9,4,3,16,0,,
1031,14,214,106,320,102,21,33,15,16,19,11,3,33,0,,
1031,5,176,100,276,57,28,32,16,15,19,7,4,30,0,,
1032,12,223,179,402,94,30,43,27,13,20,13,3,36,0,,
1032,11,162,93,255,75,18,19,13,27,13,6,4,23,0,,
1033,15,189,76,265,63,30,21,15,15,16,10,2,28,0,,
1033,1,204,107,311,79,10,46,15,15,23,12,0,35,0,,
1034,18,208,102,310,91,25,35,19,14,14,8,7,29,0,,
1034,3,157,129,286,47,24,22,14,19,9,5,3,17,0,,
1035,2,172,84,256,49,32,37,24,19,15,17,0,32,0,,
1035,13,148,84,232,58,21,39,19,24,13,3,1,17,0,,
1036,7,172,95,267,68,28,34,18,24,10,7,1,18,0,,
1036,9,195,78,273,79,39,34,24,18,16,9,2,27,0,,
1037,15,236,87,323,73,31,40,21,29,22,9,2,33,0,,
1037,14,222,115,337,90,27,29,29,21,13,9,1,23,0,,
1038,1,173,100,273,56,33,30,18,25,14,11,4,29,0,,
1038,11,186,89,275,79,22,22,25,18,14,10,3,27,0,,
1039,18,163,84,247,63,19,38,19,16,10,11,1,22,0,,
1039,10,172,102,274,69,29,16,16,19,9,7,3,19,0,,
1040,4,161,114,275,57,13,28,24,20,11,6,0,17,0,,
1040,16,231,121,352,90,26,37,20,24,17,15,2,34,0,,
1041,8,207,103,310,91,21,39,17,18,14,7,1,22,0,,
1041,5,193,114,307,73,22,23,18,17,18,13,3,34,0,,
1042,3,200,89,289,80,34,29,19,19,23,5,3,31,0,,
1042,12,195,132,327,87,29,32,19,19,9,15,1,25,0,,
1043,13,167,84,251,72,28,33,22,24,11,9,4,24,0,,
1043,7,196,116,312,86,35,41,24,22,14,11,3,28,0,,
1044,16,197,106,303,102,29,19,19,20,13,8,3,24,0,,
1044,18,163,89,252,64,20,40,20,19,14,8,4,26,0,,
1045,3,222,118,340,85,28,24,15,21,24,12,2,38,0,,
1045,15,192,69,261,69,24,41,21,15,20,10,2,32,0,,
1046,10,215,112,327,89,18,21,25,20,14,9,3,26,0,,
1046,2,176,112,288,69,25,34,20,25,8,5,2,15,0,,
1047,14,166,108,274,65,35,26,28,25,13,11,2,26,0,,
1047,1,177,101,278,67,27,31,25,28,14,9,5,28,0,,
1048,11,214,121,335,97,23,37,14,16,18,10,7,35,0,,
1048,8,191,111,302,76,22,39,16,14,11,7,3,21,0,,
1049,9,239,139,378,92,37,51,14,16,25,15,1,41,0,,
1049,4,174,91,265,68,27,25,16,14,9,11,1,21,0,,
1050,5,196,130,326,84,20,22,16,15,14,7,5,26,0,,
1050,12,240,147,387,119,22,35,15,16,23,14,1,38,0,,
1051,15,198,79,277,71,28,32,13,19,15,10,1,26,0,,
1051,2,213,118,331,78,32,34,24,13,11,11,2,24,0,,
1052,13,170,96,266,62,23,36,13,19,12,6,2,20,0,,
1052,14,185,105,290,77,31,24,19,13,15,8,3,26,0,,
1053,10,222,88,310,87,24,30,26,12,11,9,4,24,0,,
1053,3,213,79,292,91,27,36,12,26,15,2,1,18,0,,
1054,4,241,141,382,116,30,22,13,12,16,10,2,28,0,,
1054,5,173,129,302,61,15,31,12,13,10,9,3,22,0,,
1055,7,197,97,294,90,21,43,17,18,9,12,0,21,0,,
1055,11,183,98,281,84,27,20,18,17,15,8,1,24,0,,
1056,18,177,89,266,69,23,35,27,19,9,10,2,21,0,,
1056,9,201,110,311,88,26,26,19,27,17,9,7,33,0,,
1057,12,202,126,328,86,34,33,21,22,14,12,3,29,0,,
1057,1,192,82,274,85,24,21,22,21,14,7,3,24,0,,
1058,8,211,124,335,94,22,29,16,19,15,11,1,27,0,,
1058,16,209,116,325,106,22,26,19,17,9,18,5,32,0,,
1059,3,213,127,340,77,35,34,29,30,23,13,2,38,0,,
1059,4,172,105,277,58,24,30,30,29,15,3,0,18,0,,
1060,15,184,85,269,59,29,32,20,27,17,7,2,26,0,,
1060,10,199,109,308,73,34,24,27,20,15,8,3,26,0,,
1061,14,194,112,306,71,36,32,24,18,18,6,4,28,0,,
1061,18,181,100,281,68,24,34,18,24,12,12,2,26,0,,
1062,2,199,96,295,93,18,33,21,15,10,15,4,29,0,,
1062,5,196,99,295,89,25,24,15,21,16,14,2,32,0,,
1063,16,171,123,294,69,22,25,15,17,8,7,2,17,0,,
1063,12,224,170,394,104,35,35,17,15,19,11,1,31,0,,
1064,8,219,117,336,83,31,27,15,16,18,13,1,32,0,,
1064,13,174,110,284,74,16,47,16,15,8,3,3,14,0,,
1065,1,200,100,300,77,38,38,26,14,18,7,0,25,0,,
1065,7,190,121,311,82,35,29,14,26,13,10,3,26,0,,
1066,11,195,63,258,50,29,37,27,22,6,7,1,14,0,,
1066,9,243,103,346,59,36,34,22,27,11,13,4,28,0,,
1067,5,180,100,280,56,36,27,27,25,10,2,3,15,0,,
1067,3,218,100,318,51,31,44,25,27,12,10,5,27,0,,
1068,7,196,136,332,79,17,35,10,20,13,10,1,24,0,,
1068,15,225,103,328,84,19,29,16,19,16,14,4,34,0,,
1069,18,191,83,274,70,29,42,27,18,8,11,4,23,0,,
1069,13,152,102,254,68,24,26,18,27,6,7,3,16,0,,
1070,4,199,97,296,90,10,24,8,14,11,13,3,27,0,,
1070,8,193,100,293,77,29,34,14,8,12,10,2,24,0,,
1071,2,157,110,267,61,28,25,19,18,12,6,1,19,0,,
1071,1,190,103,293,87,33,33,15,13,17,11,2,30,0,,
1072,9,210,120,330,94,36,39,11,20,28,10,3,41,0,,
1072,16,184,140,324,94,28,27,20,11,9,10,3,22,0,,
1073,10,211,124,335,94,36,36,16,15,25,7,2,34,0,,
1073,11,151,95,246,66,18,31,15,16,5,9,2,16,0,,
1074,14,222,106,328,105,28,34,19,18,17,7,4,28,0,,
1074,12,190,119,309,91,32,37,11,14,15,13,1,29,0,,
1075,3,203,95,298,70,39,29,24,15,22,12,3,37,0,,
1075,2,174,127,301,76,21,39,15,24,13,9,2,24,0,,
1076,13,200,123,323,82,26,38,24,21,15,14,0,29,0,,
1076,9,200,90,290,77,29,26,21,24,25,8,1,34,0,,
1077,16,186,130,316,83,30,39,16,15,10,12,4,26,0,,
1077,10,179,112,291,66,33,27,15,16,15,17,2,34,0,,
1078,12,226,177,403,102,41,31,19,27,15,11,5,31,0,,
1078,7,175,94,269,72,27,45,27,19,7,3,0,10,0,,
1079,8,216,106,322,78,33,31,13,16,15,12,1,28,0,,
1079,14,200,110,310,68,27,25,16,13,15,8,3,26,0,,
1080,1,198,95,293,92,29,27,15,19,16,8,2,26,0,,
1080,4,197,81,278,86,33,29,19,15,16,5,3,24,0,,
1081,15,191,73,264,61,28,33,13,18,16,15,2,33,0,,
1081,5,186,82,268,68,17,33,18,13,15,9,1,25,0,,
1082,18,178,87,265,67,25,54,29,22,13,12,2,27,0,,
1082,11,174,74,248,66,31,11,22,29,9,9,5,23,0,,
1083,2,187,110,297,58,38,43,22,24,13,9,3,25,0,,
1083,12,170,114,284,60,37,37,24,22,11,8,5,24,0,,
1084,1,221,148,369,104,27,17,20,15,22,11,2,35,0,,
1084,18,186,132,318,90,33,30,15,20,11,9,3,23,0,,
1085,3,174,118,292,64,36,36,24,25,17,13,1,31,0,,
1085,13,174,90,264,54,32,31,25,24,15,8,1,24,0,,
1086,5,193,107,300,67,23,19,22,16,8,3,1,12,0,,
1086,9,211,118,329,88,17,54,14,21,13,16,0,29,0,,
1087,4,200,101,301,86,27,31,17,13,12,6,2,20,0,,
1087,7,223,131,354,70,35,35,13,17,18,12,1,31,0,,
1088,8,228,149,377,100,39,26,17,18,23,14,1,38,0,,
1088,10,177,113,290,58,27,39,18,17,11,1,1,13,0,,
1089,11,191,150,341,86,18,19,18,16,8,16,2,26,0,,
1089,15,239,98,337,83,17,36,16,18,22,6,4,32,0,,
1090,14,203,113,316,83,35,27,27,11,21,10,3,34,0,,
1090,16,186,120,306,75,30,36,11,27,13,8,2,23,0,,
1091,4,186,102,288,56,36,23,31,24,9,9,2,20,0,,
1091,1,203,142,345,66,31,28,24,31,8,11,1,20,0,,
1092,15,227,85,312,57,44,34,19,21,15,6,4,25,0,,
1092,18,201,86,287,50,32,47,21,19,8,4,4,16,0,,
1093,9,228,114,342,77,36,45,19,27,20,14,4,38,0,,
1093,12,202,133,335,87,30,23,27,19,8,15,2,25,0,,
1094,3,229,121,350,83,24,28,31,16,18,12,3,33,0,,
1094,10,192,66,258,75,23,24,16,31,7,8,4,19,0,,
1095,12,215,138,353,87,32,44,20,13,18,12,4,34,0,,
1095,4,171,104,275,90,26,27,13,20,10,6,4,20,0,,
1096,9,187,95,282,69,42,34,22,26,19,11,1,31,0,,
1096,1,185,121,306,79,26,36,26,22,10,11,2,23,0,,
1097,15,225,83,308,76,31,34,15,17,19,9,0,28,0,,
1097,9,183,123,306,73,18,36,17,15,11,10,2,23,0,,
1098,12,187,107,294,89,27,29,19,14,16,6,2,24,0,,
1098,3,181,92,273,62,47,36,14,19,14,18,1,33,0,,
1099,15,204,89,293,74,37,28,19,19,19,5,5,29,0,,
1099,12,182,136,318,67,21,45,19,19,12,13,4,29,0,,
1100,2,202,73,275,62,37,34,36,27,14,9,1,24,0,,
1100,13,183,89,272,59,28,33,27,36,13,12,2,27,0,,
1101,3,213,136,349,79,38,27,33,15,24,11,1,36,0,,
1101,18,194,134,328,90,24,29,15,33,8,11,3,22,0,,
1102,15,204,99,303,70,20,33,28,22,16,15,0,31,0,,
1102,4,221,120,341,83,22,31,22,28,24,8,2,34,0,,
1103,16,196,141,337,67,32,26,24,26,16,9,2,27,0,,
1103,14,197,104,301,66,22,18,26,24,19,10,5,34,0,,
1104,11,166,95,261,59,25,21,21,23,15,16,2,33,0,,
1104,1,211,121,332,89,25,11,23,21,19,14,3,36,0,,
1105,7,195,102,297,63,13,24,20,24,15,8,2,25,0,,
1105,10,224,111,335,105,23,26,24,20,21,7,1,29,0,,
1106,12,230,136,366,95,17,41,18,20,22,20,0,42,0,,
1106,9,181,100,281,75,18,19,20,18,16,7,9,32,0,,
1107,8,192,94,286,71,22,40,19,24,13,7,1,21,0,,
1107,5,231,109,340,85,22,29,24,19,20,18,2,40,0,,
1108,2,219,100,319,103,38,24,21,13,12,11,4,27,0,,
1108,3,211,118,329,91,32,21,13,21,20,4,6,30,0,,
1109,13,221,91,312,103,27,25,19,31,23,6,1,30,0,,
1109,15,196,86,282,55,40,38,31,19,17,16,2,35,0,,
1110,14,206,101,307,83,35,24,25,27,21,11,2,34,0,,
1110,7,182,76,258,62,28,37,27,25,15,8,1,24,0,,
1111,18,185,114,299,71,27,24,21,21,12,11,4,27,0,,
1111,16,199,124,323,86,36,25,21,21,19,9,2,30,0,,
1112,1,191,111,302,82,18,29,26,26,17,7,1,25,0,,
1112,9,226,98,324,95,47,25,26,26,21,10,3,34,0,,
1113,12,227,157,384,86,44,34,21,21,22,18,4,44,0,,
1113,8,195,99,294,80,31,28,21,21,18,2,2,22,0,,
1114,4,196,108,304,83,18,28,26,27,10,8,2,20,0,,
1114,10,234,104,338,114,20,29,27,26,12,10,0,22,0,,
1115,5,182,103,285,76,31,22,20,16,14,14,5,33,0,,
1115,11,177,84,261,64,27,41,16,20,13,11,3,27,0,,
1116,2,232,107,339,105,25,30,24,21,20,14,0,34,0,,
1116,15,199,74,273,65,33,28,21,24,27,6,2,35,0,,
1117,7,208,83,291,74,29,33,23,21,18,6,2,26,0,,
1118,8,223,100,323,86,23,21,21,15,16,14,0,30,0,,
1118,9,181,82,263,57,17,29,15,21,15,11,2,28,0,,
1119,11,213,115,328,85,14,20,22,20,14,11,5,30,0,,
1119,14,209,99,308,87,30,21,20,22,17,5,4,26,0,,
1120,1,185,113,298,63,33,31,30,21,22,9,0,31,0,,
1120,18,180,87,267,62,35,31,21,30,14,9,1,24,0,,
1121,10,213,90,303,88,32,32,15,17,19,11,1,31,0,,
1121,13,202,108,310,79,24,40,17,15,17,10,2,29,0,,
1122,16,179,106,285,57,40,32,28,20,12,12,4,28,0,,
1122,3,179,105,284,68,28,23,20,28,19,9,1,29,0,,
1123,5,230,116,346,105,28,24,15,22,24,13,3,40,0,,
1123,12,199,116,315,74,31,37,22,15,11,18,3,32,0,,
1124,15,227,79,306,88,25,22,25,24,15,12,2,29,0,,
1124,14,228,103,331,108,18,20,24,25,15,8,1,24,0,,
1125,8,232,103,335,119,28,29,32,20,14,5,1,20,0,,
1125,3,233,133,366,79,25,29,20,32,20,12,5,37,0,,
1126,10,188,90,278,59,17,31,26,24,15,10,1,26,0,,
1126,5,214,94,308,89,32,16,24,26,15,12,4,31,0,,
1127,1,175,94,269,75,31,44,23,20,14,11,3,28,0,,
1127,12,202,92,294,95,40,26,20,23,8,8,3,19,0,,
1128,4,226,129,355,98,21,36,21,13,29,9,4,42,0,,
1128,11,173,100,273,54,22,34,13,21,10,11,2,23,0,,
1129,18,206,134,340,74,30,36,24,17,23,8,3,34,0,,
1129,9,188,84,272,90,29,26,17,24,15,9,7,31,0,,
1130,13,217,109,326,84,29,30,21,16,25,14,1,40,0,,
1130,7,187,89,276,76,33,31,16,21,11,4,5,20,0,,
1131,16,199,103,302,91,32,18,12,19,12,13,3,28,0,,
1131,2,190,105,295,86,26,36,19,12,13,7,2,22,0,,
1132,1,181,75,256,72,27,34,19,23,16,9,5,30,0,,
1132,5,196,79,275,102,37,20,23,19,17,16,0,33,0,,
1133,16,194,100,294,84,26,22,24,28,10,12,3,25,0,,
1133,13,214,116,330,96,26,29,28,24,14,17,5,36,0,,
1134,9,234,73,307,85,38,28,17,14,17,13,7,37,0,,
1134,11,182,98,280,51,25,40,14,17,13,13,1,27,0,,
1135,3,224,115,339,93,29,32,22,21,18,13,2,33,0,,
1135,12,224,119,343,96,29,22,21,22,15,9,0,24,0,,
1136,15,207,108,315,72,26,25,12,19,19,10,4,33,0,,
1136,10,201,122,323,90,23,31,19,12,18,9,3,30,0,,
1137,14,238,119,357,104,26,29,18,7,24,17,1,42,0,,
1137,4,171,111,282,61,38,20,7,18,11,15,0,26,0,,
1138,7,201,105,306,77,28,29,13,21,11,13,5,29,0,,
1138,2,214,120,334,90,31,20,21,13,17,7,1,25,0,,
1139,18,190,93,283,73,24,27,28,24,10,11,3,24,0,,
1139,8,229,95,324,96,33,18,24,28,16,14,3,33,0,,
1140,1,174,119,293,71,21,37,25,17,12,4,5,21,0,,
1140,3,202,104,306,66,49,25,17,25,22,9,3,34,0,,
1141,7,205,115,320,88,16,32,22,19,9,10,2,21,0,,
1141,9,230,100,330,110,36,23,19,22,15,13,2,30,0,,
1142,5,213,137,350,96,25,18,15,17,11,12,4,27,0,,
1142,15,215,101,316,80,40,38,17,15,17,10,2,29,0,,
1143,12,233,172,405,102,34,39,27,24,26,11,2,39,0,,
1143,18,146,63,209,49,28,28,24,27,12,5,1,18,0,,
1144,4,214,140,354,87,29,35,15,20,28,8,2,38,0,,
1144,16,173,113,286,66,27,26,20,15,9,6,1,16,0,,
1145,14,198,90,288,75,23,18,27,19,15,16,3,34,0,,
1145,13,177,110,287,73,41,39,19,27,12,12,0,24,0,,
1146,11,214,125,339,88,31,21,18,9,22,8,3,33,0,,
1146,8,199,103,302,90,26,41,9,18,8,8,1,17,0,,
1147,10,187,102,289,72,25,36,17,19,16,6,4,26,0,,
1147,2,194,100,294,74,22,29,19,17,17,5,5,27,0,,
1148,7,223,121,344,85,26,30,17,21,18,8,1,27,0,,
1148,15,218,106,324,86,33,35,21,17,19,14,1,34,0,,
1149,10,199,103,302,88,28,37,18,13,15,9,0,24,0,,
1149,14,183,88,271,70,19,26,13,18,17,6,0,23,0,,
1150,8,206,72,278,94,35,34,23,14,19,7,2,28,0,,
1150,1,186,124,310,70,24,25,14,23,14,6,2,22,0,,
1151,18,188,81,269,83,41,36,24,19,13,11,2,26,0,,
1151,11,182,112,294,57,34,39,19,24,14,11,3,28,0,,
1152,13,239,117,356,100,23,31,21,14,20,15,3,38,0,,
1152,4,191,106,297,80,25,25,14,21,12,3,2,17,0,,
1153,2,195,104,299,80,34,24,22,12,10,6,3,19,0,,
1153,12,198,120,318,84,47,37,12,22,18,11,1,30,0,,
1154,16,191,128,319,84,16,32,20,10,17,9,0,26,0,,
1154,9,184,105,289,76,21,33,10,20,15,10,0,25,0,,
1155,5,204,91,295,91,32,22,14,12,15,8,2,25,0,,
1155,3,230,134,364,98,36,37,12,14,21,11,3,35,0,,
1156,15,203,102,305,69,30,20,17,19,9,10,3,22,0,,
1156,8,248,141,389,103,30,28,19,17,18,15,5,38,0,,
1157,4,195,120,315,75,30,26,23,22,15,17,1,33,0,,
1157,1,192,112,304,81,28,23,22,23,15,10,2,27,0,,
1158,7,166,101,267,54,39,37,17,15,10,7,1,18,0,,
1158,11,190,100,290,81,39,27,15,17,14,20,4,38,0,,
1159,12,226,174,400,92,25,30,11,19,16,11,2,29,0,,
1159,10,191,134,325,79,39,24,19,11,9,10,0,19,0,,
1160,18,199,97,296,72,26,33,19,15,12,12,2,26,0,,
1160,13,207,113,320,105,25,22,15,19,17,9,0,26,0,,
1161,2,223,140,363,103,33,31,12,15,23,6,3,32,0,,
1161,14,156,108,264,64,31,26,15,12,11,7,4,22,0,,
1162,9,204,101,305,45,33,25,26,28,9,7,2,18,0,,
1162,3,256,114,370,80,26,38,28,26,19,10,3,32,0,,
1163,16,197,115,312,81,37,40,22,17,15,14,3,32,0,,
1163,5,176,124,300,76,35,19,17,22,12,12,1,25,0,,
1164,1,193,132,325,70,33,36,26,22,16,6,3,25,0,,
1164,7,202,119,321,79,40,34,22,26,16,6,2,24,0,,
1165,11,234,102,336,94,32,26,15,15,19,7,4,30,0,,
1165,15,243,98,341,76,37,42,15,15,19,14,0,33,0,,
1166,8,226,95,321,98,33,21,18,18,14,13,1,28,0,,
1166,14,195,108,303,67,31,31,18,18,10,10,3,23,0,,
1167,2,216,129,345,74,40,39,15,17,11,10,3,24,0,,
1167,4,179,127,306,68,45,33,17,15,9,12,4,25,0,,
1168,10,198,94,292,86,24,29,13,13,16,13,2,31,0,,
1168,18,191,84,275,94,22,31,13,13,11,14,5,30,0,,
1169,13,201,126,327,89,25,29,24,26,13,12,3,28,0,,
1169,3,206,111,317,89,38,27,26,24,15,13,3,31,0,,
1170,9,212,106,318,82,38,52,16,11,22,11,3,36,0,,
1170,5,202,128,330,83,16,21,11,16,18,7,2,27,0,,
1171,16,183,115,298,69,46,31,16,13,13,4,0,17,0,,
1171,12,202,158,360,67,42,37,13,16,21,19,2,42,0,,
1172,4,219,129,348,88,27,28,14,14,17,13,3,33,0,,
1172,8,215,115,330,76,19,26,14,14,13,8,2,23,0,,
1173,18,192,121,313,66,29,32,21,16,10,10,8,28,0,,
1174,2,233,128,361,112,22,29,10,25,15,9,3,27,0,,
1174,5,206,112,318,98,39,15,25,10,7,8,4,19,0,,
1175,7,218,118,336,96,31,34,19,20,11,15,1,27,0,,
1175,12,204,116,320,88,35,22,20,19,15,14,5,34,0,,
1176,15,212,105,317,88,41,36,17,17,22,9,7,38,0,,
1176,16,205,90,295,107,44,24,17,17,8,8,4,20,0,,
1177,10,167,125,292,69,24,35,15,18,12,7,0,19,0,,
1177,1,222,112,334,106,15,22,18,15,21,9,2,32,0,,
1178,3,208,127,335,84,48,32,12,13,20,9,3,32,0,,
1178,11,182,112,294,61,40,36,13,12,12,8,4,24,0,,
1179,13,206,108,314,78,35,31,21,13,15,10,2,27,0,,
1179,9,198,109,307,88,46,24,13,21,11,13,5,29,0,,
1180,7,218,111,329,93,39,30,24,19,17,12,3,32,0,,
1180,18,181,102,283,79,54,22,19,24,8,6,1,15,0,,
1181,8,189,108,297,89,38,27,10,16,11,5,6,22,0,,
1181,2,208,115,323,89,30,26,16,10,11,12,2,25,0,,
1182,3,227,119,346,103,38,20,16,25,22,12,1,35,0,,
1182,14,207,95,302,84,30,25,25,16,13,6,3,22,0,,
1183,12,213,125,338,91,32,36,20,23,20,9,0,29,0,,
1183,15,201,91,292,66,31,34,23,20,15,4,5,24,0,,
1184,16,164,84,248,65,41,26,19,20,12,8,1,21,0,,
1184,1,219,146,365,101,32,27,20,19,27,10,2,39,0,,
1185,10,193,111,304,89,21,35,14,13,15,13,4,32,0,,
1185,9,189,118,307,62,18,29,13,14,16,13,1,30,0,,
1186,11,217,114,331,117,41,23,10,11,15,12,3,30,0,,
1186,13,199,142,341,89,26,18,11,10,8,21,1,30,0,,
1187,4,199,111,310,78,44,39,9,12,18,13,7,38,0,,
1187,5,176,125,301,62,31,25,12,9,13,13,1,27,0,,
1188,3,232,99,331,100,51,24,16,11,25,18,1,44,0,,
1188,7,172,96,268,75,20,46,11,16,13,4,1,18,0,,
1189,5,196,84,280,77,38,28,24,24,9,12,1,22,0,,
1189,14,201,91,292,52,30,45,24,24,10,10,1,21,0,,
1190,11,235,144,379,87,43,32,17,20,14,8,6,28,0,,
1190,10,163,104,267,41,32,27,20,17,7,5,1,13,0,,
1191,9,190,116,306,71,25,39,17,18,14,9,6,29,0,,
1191,2,211,109,320,88,18,37,18,17,17,8,1,26,0,,
1192,8,226,134,360,108,39,29,21,17,19,5,2,26,0,,
1192,16,201,146,347,84,34,26,17,21,8,10,4,22,0,,
1193,15,189,85,274,64,51,29,23,13,10,12,4,26,0,,
1193,18,199,112,311,73,26,27,13,23,8,9,2,19,0,,
1194,1,200,85,285,83,40,39,26,12,16,9,3,28,0,,
1194,13,163,111,274,70,40,31,12,26,13,5,0,18,0,,
1195,4,181,102,283,69,46,33,21,15,11,9,3,23,0,,
1195,12,209,138,347,80,42,37,15,21,20,8,0,28,0,,
1196,11,195,121,316,87,26,29,14,21,17,16,3,36,0,,
1196,2,205,122,327,86,35,30,21,14,17,8,2,27,0,,
1197,9,226,128,354,92,24,40,17,16,27,11,0,38,0,,
1197,4,192,102,294,57,25,40,16,17,13,7,4,24,0,,
1198,18,215,84,299,81,27,33,19,16,12,15,2,29,0,,
1198,5,190,101,291,71,39,22,16,19,11,6,3,20,0,,
1199,13,175,119,294,73,34,38,17,18,9,5,2,16,0,,
1199,12,205,152,357,86,51,34,18,17,25,9,0,34,0,,
1200,16,236,131,367,119,19,31,17,9,14,14,2,30,0,,
1200,7,196,103,299,92,28,18,9,17,8,8,0,16,0,,
1201,1,193,113,306,67,27,33,16,16,18,9,2,29,0,,
1201,14,192,111,303,76,39,40,16,16,19,7,5,31,0,,
1202,10,201,128,329,90,27,25,20,16,16,9,4,29,0,,
1202,8,174,124,298,75,21,22,16,20,11,7,5,23,0,,
1203,15,193,72,265,89,40,27,20,17,11,4,0,15,0,,
1203,3,222,114,336,106,31,26,17,20,17,13,4,34,0,,
1204,15,203,96,299,83,45,35,15,14,17,9,5,31,0,,
1204,9,212,108,320,106,34,23,14,15,17,7,3,27,0,,
1205,4,190,79,269,51,42,54,20,21,10,10,1,21,0,,
1205,18,208,85,293,51,21,33,21,20,16,6,5,27,0,,
1206,13,201,118,319,89,42,41,19,20,22,6,5,33,0,,
1206,5,178,86,264,68,30,21,20,19,12,6,0,18,0,,
1207,8,224,120,344,114,40,34,17,13,27,9,0,36,0,,
1207,7,192,112,304,75,24,33,13,17,13,8,0,21,0,,
1208,12,197,91,288,68,38,30,15,11,15,15,2,32,0,,
1208,14,183,115,298,84,34,36,11,15,15,4,3,22,0,,
1209,11,239,117,356,94,36,39,17,18,22,9,4,35,0,,
1209,16,202,106,308,80,33,24,18,17,11,6,0,17,0,,
1210,10,189,97,286,83,40,37,19,18,11,6,4,21,0,,
1210,3,169,122,291,51,19,32,18,19,12,11,6,29,0,,
1211,2,208,92,300,109,32,23,13,12,12,13,2,27,0,,
1211,1,193,111,304,101,23,26,12,13,7,7,3,17,0,,
1212,5,220,112,332,92,38,28,18,15,17,10,3,30,0,,
1212,7,184,108,292,72,27,30,15,18,13,4,0,17,0,,
1213,8,204,137,341,91,29,22,8,14,10,11,1,22,0,,
1213,13,221,138,359,97,33,31,14,8,22,8,1,31,0,,
1214,14,199,128,327,98,22,19,14,19,7,14,3,24,0,,
1214,9,194,126,320,70,46,40,19,14,20,7,1,28,0,,
1215,3,206,143,349,92,32,33,15,16,15,14,4,33,0,,
1215,4,218,105,323,101,24,27,16,15,11,6,4,21,0,,
1216,12,196,149,345,73,49,35,14,13,19,4,2,25,0,,
1216,11,168,104,272,62,35,40,13,14,14,8,4,26,0,,
1217,18,194,115,309,70,26,35,12,13,15,10,3,28,0,,
1217,2,173,87,260,77,36,29,13,12,11,7,2,20,0,,
1218,16,183,125,308,76,21,31,31,12,20,2,1,23,0,,
1218,10,178,110,288,69,29,45,12,31,14,8,4,26,0,,
1219,1,211,124,335,99,26,22,19,22,16,9,1,26,0,,
1219,15,199,76,275,90,52,28,22,19,15,11,1,27,0,,
1220,8,218,126,344,110,31,31,16,16,19,10,1,30,0,,
1220,5,213,108,321,103,24,25,16,16,10,6,2,18,0,,
1221,13,205,142,347,71,46,36,16,19,16,14,0,30,0,,
1221,2,189,94,283,82,31,27,19,16,14,12,4,30,0,,
1222,10,216,91,307,103,31,27,18,15,14,7,2,23,0,,
1222,7,182,132,314,70,19,33,15,18,10,4,1,15,0,,
1223,14,207,127,334,104,30,23,22,12,12,14,4,30,0,,
1223,16,194,135,329,82,28,24,12,22,12,10,2,24,0,,
1224,18,205,91,296,90,30,19,18,13,7,15,1,23,0,,
1224,3,228,116,344,111,32,17,13,18,12,15,2,29,0,,
1225,4,199,88,287,59,40,48,20,19,7,6,4,17,0,,
1225,15,202,96,298,55,39,47,19,20,16,13,4,33,0,,
1226,9,167,93,260,64,28,55,17,21,17,9,1,27,0,,
1226,12,206,135,341,79,30,26,21,17,23,17,1,41,0,,
1227,1,203,122,325,92,41,28,16,18,21,7,2,30,0,,
1227,11,194,91,285,102,28,29,18,16,10,8,6,24,0,,
1228,7,211,118,329,82,30,31,17,17,16,10,3,29,0,,
1228,14,199,119,318,98,38,27,17,17,13,6,1,20,0,,
1229,16,202,113,315,51,67,34,22,30,12,7,3,22,0,,
1229,18,200,79,279,37,45,52,30,22,8,12,4,24,0,,
1230,2,185,97,282,96,23,26,15,12,10,5,1,16,0,,
1230,3,198,120,318,84,42,33,12,15,24,21,2,47,0,,
1231,15,197,71,268,78,42,36,21,14,14,17,2,33,0,,
1231,13,183,118,301,72,40,24,14,21,14,13,5,32,0,,
1232,10,213,127,340,96,16,27,9,15,22,14,5,41,0,,
1232,4,173,92,265,58,15,28,15,9,12,7,1,20,0,,
1233,11,229,138,367,99,20,32,10,14,22,13,2,37,0,,
1233,5,188,112,300,86,27,25,14,10,16,13,0,29,0,,
1234,9,208,145,353,100,47,35,12,13,20,16,2,38,0,,
1234,1,210,100,310,100,15,21,13,12,11,14,1,26,0,,
1235,8,196,80,276,98,28,30,18,11,9,5,4,18,0,,
1235,12,196,138,334,85,22,27,11,18,18,11,1,30,0,,
1236,3,201,173,374,70,41,31,15,12,24,15,0,39,0,,
1236,16,175,98,273,86,34,34,12,15,11,4,2,17,0,,
1237,15,223,84,307,89,23,33,10,13,20,12,2,34,0,,
1237,2,205,92,297,104,20,20,13,10,7,9,5,21,0,,
1238,13,184,124,308,86,17,37,18,18,19,10,1,30,0,,
1238,10,183,95,278,88,38,24,18,18,15,8,1,24,0,,
1239,4,239,137,376,125,24,28,14,15,17,11,2,30,0,,
1239,7,208,150,358,103,17,22,15,14,4,5,0,9,0,,
1240,14,180,88,268,69,37,33,17,19,17,5,2,24,0,,
1240,11,196,98,294,87,39,33,19,17,14,14,4,32,0,,
1241,12,202,140,342,99,38,47,12,20,28,10,2,40,0,,
1241,5,163,99,262,66,44,25,20,12,10,8,1,19,0,,
1242,9,192,125,317,88,28,36,21,12,16,10,0,26,0,,
1242,8,220,121,341,103,29,22,12,21,18,11,5,34,0,,
1243,18,193,82,275,83,45,33,22,17,23,11,0,34,0,,
1243,1,195,116,311,84,37,34,17,22,16,9,1,26,0,,
1244,11,209,112,321,60,30,42,16,18,15,16,1,32,0,,
1244,4,203,86,289,57,20,38,18,16,13,10,2,25,0,,
1245,15,217,91,308,74,48,41,30,19,18,14,2,34,0,,
1245,14,201,112,313,71,34,20,19,30,13,6,1,20,0,,
1246,3,218,150,368,105,34,34,13,24,25,9,6,40,0,,
1246,8,204,108,312,96,38,29,24,13,13,1,3,17,0,,
1247,12,198,149,347,93,48,23,9,26,11,6,0,17,0,,
1247,1,189,119,308,71,43,36,26,9,11,7,2,20,0,,
1248,16,203,121,324,82,27,20,14,19,12,5,2,19,0,,
1248,2,210,148,358,76,33,33,19,14,15,16,0,31,0,,
1249,5,181,121,302,75,28,26,14,13,12,11,1,24,0,,
1249,10,210,104,314,104,33,41,13,14,15,11,3,29,0,,
1250,9,187,114,301,89,55,31,9,11,18,10,2,30,0,,
1250,18,180,127,307,83,26,36,11,9,7,7,4,18,0,,
1251,7,212,107,319,97,43,18,14,15,14,14,0,28,0,,
1251,13,200,106,306,87,32,43,15,14,17,12,2,31,0,,
1252,3,214,136,350,89,38,24,13,22,16,12,1,29,0,,
1252,12,195,118,313,70,34,37,22,13,12,7,4,23,0,,
1253,8,218,134,352,98,27,30,22,20,15,9,2,26,0,,
1253,18,202,127,329,89,36,30,20,22,12,6,2,20,0,,
1254,10,219,128,347,95,20,15,20,12,21,17,2,40,0,,
1254,15,201,84,285,84,21,32,12,20,14,6,1,21,0,,
1255,4,192,101,293,46,39,31,21,18,12,5,1,18,0,,
1255,14,220,101,321,74,32,37,18,21,14,18,6,38,0,,
1256,1,191,139,330,79,29,45,16,15,15,9,1,25,0,,
1256,5,200,117,317,105,32,14,15,16,13,12,1,26,0,,
1257,2,190,118,308,76,37,39,28,12,18,10,1,29,0,,
1257,7,189,79,268,81,38,18,12,28,12,4,3,19,0,,
1258,11,184,100,284,69,21,36,23,13,11,11,1,23,0,,
1258,9,220,118,338,110,29,30,13,23,17,12,1,30,0,,
1259,13,199,142,341,61,28,46,23,17,25,10,0,35,0,,
1259,16,175,111,286,55,46,24,17,23,11,10,1,22,0,,
1260,3,213,110,323,116,33,26,10,19,12,9,0,21,0,,
1260,1,219,117,336,108,34,31,19,10,14,8,0,22,0,,
1261,9,217,151,368,105,29,31,17,18,23,12,3,38,0,,
1261,7,197,106,303,78,28,30,18,17,8,13,2,23,0,,
1262,8,227,140,367,124,25,25,20,18,15,8,0,23,0,,
1262,11,201,117,318,100,28,25,18,20,9,10,3,22,0,,
1263,10,199,143,342,91,46,31,12,14,12,11,1,24,0,,
1263,2,186,102,288,78,32,34,14,12,12,7,4,23,0,,
1264,16,220,96,316,100,34,32,18,22,15,10,1,26,0,,
1264,4,203,99,302,75,27,35,22,18,15,8,2,25,0,,
1265,13,197,113,310,79,24,33,18,16,18,16,2,36,0,,
1265,14,179,104,283,68,25,22,16,18,17,6,0,23,0,,
1266,18,190,110,300,77,36,29,21,15,12,14,2,28,0,,
1266,12,179,148,327,77,33,25,15,21,12,6,5,23,0,,
1267,5,217,105,322,122,22,20,16,13,14,13,1,28,0,,
1267,15,198,76,274,88,36,29,13,16,11,10,4,25,0,,
1268,1,214,129,343,127,31,20,15,10,9,9,3,21,0,,
1268,8,242,117,359,149,36,25,10,15,11,11,4,26,0,,
1269,14,193,113,306,70,39,30,26,15,18,13,3,34,0,,
1269,10,187,125,312,76,41,32,15,26,18,9,3,30,0,,
1270,5,193,99,292,98,18,17,14,11,11,8,4,23,0,,
1270,3,210,123,333,99,23,35,11,14,13,18,1,32,0,,
1271,7,229,117,346,111,31,34,16,11,10,12,5,27,0,,
1271,15,219,91,310,89,26,24,11,16,18,11,1,30,0,,
1272,9,216,155,371,91,31,44,11,17,23,11,7,41,0,,
1272,16,179,91,270,75,24,30,17,11,7,5,2,14,0,,
1273,11,173,106,279,77,33,29,12,16,14,8,0,22,0,,
1273,18,209,130,339,87,42,25,16,12,20,17,2,39,0,,
1274,4,185,122,307,61,40,35,16,12,15,9,1,25,0,,
1274,13,207,145,352,61,37,65,12,16,26,11,3,40,0,,
1275,2,181,96,277,72,37,25,20,14,7,8,2,17,0,,
1275,12,196,131,327,98,54,33,14,20,19,10,1,30,0,,
1276,8,204,97,301,104,33,27,11,15,14,5,3,22,0,,
1276,14,187,96,283,67,44,36,15,11,12,9,2,23,0,,
1277,9,224,137,361,102,34,26,14,14,15,17,3,35,0,,
1277,1,179,133,312,85,15,31,14,14,10,12,4,26,0,,
1278,3,252,156,408,111,32,23,10,16,31,11,1,43,0,,
1278,15,181,77,258,65,37,33,16,10,11,7,0,18,0,,
1279,13,183,118,301,80,32,33,18,17,15,6,0,21,0,,
1279,12,205,109,314,95,47,39,17,18,12,11,4,27,0,,
1280,15,202,87,289,93,44,33,13,14,16,12,2,30,0,,
1280,8,206,87,293,98,35,21,14,13,15,7,3,25,0,,
1281,12,195,147,342,89,39,31,12,22,23,12,1,36,0,,
1281,9,177,100,277,83,30,33,22,12,10,8,1,19,0,,
1282,13,217,117,334,80,43,47,20,22,23,16,2,41,0,,
1282,15,189,64,253,71,39,30,22,20,17,3,1,21,0,,
1283,3,178,127,305,64,66,33,19,13,18,14,3,35,0,,
1283,12,173,111,284,78,43,33,13,19,12,8,0,20,0,,
1284,3,226,106,332,100,50,18,21,21,19,18,3,40,0,,
1284,13,171,94,265,73,30,39,21,21,11,8,1,20,0,,
1285,15,200,79,279,75,36,31,23,20,9,7,0,16,0,,
1285,3,231,118,349,114,28,22,20,23,23,8,0,31,0,,
1286,18,186,94,280,66,22,28,16,13,14,12,3,29,0,,
1286,9,186,92,278,83,21,21,13,16,14,8,1,23,0,,
1287,1,165,81,246,67,37,20,15,12,16,8,3,27,0,,
1287,7,202,75,277,98,37,42,12,15,16,12,4,32,0,,
1288,8,212,94,306,112,27,22,22,32,13,7,0,20,0,,
1288,5,215,113,328,97,24,23,32,22,11,12,3,26,0,,
1289,16,212,121,333,74,22,26,15,18,18,6,4,28,0,,
1289,12,208,139,347,72,30,46,17,15,18,7,4,29,0,,
1290,13,176,84,260,65,27,34,25,22,15,10,3,28,0,,
1290,2,194,103,297,95,44,14,22,25,20,12,2,34,0,,
1291,14,220,121,341,110,33,26,16,21,17,10,3,30,0,,
1291,4,190,106,296,84,39,35,21,16,7,5,2,14,0,,
1292,10,211,117,328,105,24,12,11,12,19,9,3,31,0,,
1292,11,171,105,276,70,19,24,12,11,10,11,3,24,0,,
1293,3,192,99,291,72,43,21,22,19,23,7,0,30,0,,
1293,18,187,75,262,81,31,35,19,22,16,7,4,27,0,,
1294,12,201,115,316,87,24,20,34,19,11,14,1,26,0,,
1294,8,221,104,325,121,27,18,19,34,16,8,3,27,0,,
1295,11,206,111,317,59,47,35,20,14,11,11,3,25,0,,
1295,13,196,113,309,63,28,22,14,20,12,10,1,23,0,,
1296,2,177,111,288,88,29,16,21,18,9,13,2,24,0,,
1296,1,192,100,292,99,33,26,18,21,17,8,1,26,0,,
1297,5,207,130,337,76,30,27,18,17,15,13,2,30,0,,
1297,16,190,98,288,90,27,27,17,18,13,7,3,23,0,,
1298,4,199,116,315,81,33,42,13,19,13,8,3,24,0,,
1298,10,208,84,292,92,20,24,19,13,15,10,4,29,0,,
1299,9,183,112,295,84,40,30,16,19,17,15,1,33,0,,
1299,15,168,85,253,67,31,23,19,16,8,9,1,18,0,,
1300,7,195,92,287,72,31,42,19,20,13,6,2,21,0,,
1300,14,193,104,297,66,47,25,20,19,17,13,0,30,0,,
1301,12,189,103,292,73,47,41,26,11,14,6,3,23,0,,
1301,3,188,130,318,87,31,25,11,26,11,7,3,21,0,,
1302,2,199,144,343,82,40,25,17,20,17,14,0,31,0,,
1302,9,157,108,265,58,41,42,20,17,14,8,2,24,0,,
1303,15,184,72,256,76,35,34,20,18,11,4,1,16,0,,
1303,10,196,115,311,74,35,21,18,20,23,11,2,36,0,,
1304,1,162,122,284,77,26,24,18,16,12,8,1,21,0,,
1304,5,230,111,341,119,29,26,16,18,23,11,4,38,0,,
1305,7,182,85,267,78,24,33,18,12,16,10,1,27,0,,
1305,4,204,108,312,96,25,29,12,18,19,11,0,30,0,,
1306,16,218,121,339,100,30,18,29,13,8,10,1,19,0,,
1306,8,216,118,334,105,15,20,13,29,11,14,2,27,0,,
1307,11,169,91,260,65,49,34,23,20,13,9,1,23,0,,
1307,18,203,107,310,74,33,21,20,23,23,12,3,38,0,,
1308,13,216,95,311,101,27,33,17,17,18,15,1,34,0,,
1308,14,183,106,289,76,27,21,17,17,15,12,2,29,0,,
1309,5,172,109,281,73,32,21,20,9,10,9,2,21,0,,
1309,2,203,109,312,103,34,24,9,20,13,7,1,21,0,,
1310,10,210,107,317,72,26,29,29,23,6,13,6,25,0,,
1310,3,212,103,315,78,25,25,23,29,15,8,4,27,0,,
1311,18,215,151,366,91,47,36,12,18,17,12,0,29,0,,
1311,7,157,78,235,49,40,26,18,12,7,7,1,15,0,,
1312,16,206,119,325,83,27,19,25,19,13,9,1,23,0,,
1312,4,203,92,295,73,33,31,19,25,16,13,3,32,0,,
1313,1,204,107,311,98,21,22,19,11,21,13,1,35,0,,
1313,9,202,114,316,118,32,28,11,19,12,15,0,27,0,,
1314,12,192,85,277,41,43,43,28,21,8,3,2,13,0,,
1314,11,208,55,263,34,37,27,21,28,9,6,2,17,0,,
1315,8,240,91,331,77,49,12,18,22,11,13,4,28,0,,
1315,13,193,98,291,37,36,32,22,18,5,12,2,19,0,,
1316,14,198,60,258,39,44,46,23,23,4,6,3,13,0,,
1316,15,227,65,292,47,61,50,23,23,7,11,0,18,0,,
1317,5,202,90,292,104,27,14,22,14,14,7,4,25,0,,
1317,3,175,94,269,66,41,36,14,22,15,10,3,28,0,,
1318,4,182,80,262,72,33,21,26,12,11,4,0,15,0,,
1318,2,208,132,340,103,28,31,12,26,17,6,1,24,0,,
1319,1,185,85,270,88,26,20,23,20,19,11,1,31,0,,
1319,8,201,128,329,97,28,24,20,23,24,9,2,35,0,,
1320,12,207,122,329,85,38,35,17,17,17,17,6,40,0,,
1320,7,181,147,328,83,21,27,17,17,14,6,2,22,0,,
1321,11,188,93,281,62,32,33,20,24,12,16,2,30,0,,
1321,15,177,58,235,66,33,26,24,20,10,13,2,25,0,,
1322,13,197,114,311,80,29,33,18,23,18,10,1,29,0,,
1322,10,205,117,322,83,26,18,23,18,15,10,4,29,0,,
1323,14,176,101,277,83,33,22,22,34,15,10,2,27,0,,
1323,18,211,129,340,81,40,30,34,22,23,9,1,33,0,,
1324,9,200,143,343,72,44,39,14,25,25,16,5,46,0,,
1324,16,221,127,348,98,24,24,25,14,19,6,2,27,0,,
1325,2,200,134,334,82,33,36,17,19,19,12,3,34,0,,
1325,15,157,90,247,66,38,28,19,17,12,5,1,18,0,,
1326,7,212,140,352,88,19,37,13,8,18,11,1,30,0,,
1326,10,206,124,330,96,31,26,8,13,14,8,2,24,0,,
1327,16,204,139,343,82,38,26,15,13,9,15,5,29,0,,
1327,13,218,116,334,111,26,12,13,15,18,10,1,29,0,,
1328,9,210,147,357,87,39,25,26,20,17,11,3,31,0,,
1328,14,190,116,306,90,24,21,20,26,8,11,2,21,0,,
1329,18,220,115,335,113,27,40,13,11,20,6,3,29,0,,
1329,1,213,127,340,104,32,9,11,13,13,5,3,21,0,,
1330,3,200,152,352,78,29,32,20,18,24,10,4,38,0,,
1330,4,178,108,286,82,37,27,18,20,10,7,3,20,0,,
1331,5,188,84,272,99,25,18,22,21,15,11,2,28,0,,
1331,12,196,96,292,84,28,26,21,22,14,10,1,25,0,,
1332,8,237,97,334,126,18,13,18,13,16,7,1,24,0,,
1332,11,217,90,307,116,26,23,13,18,12,17,2,31,0,,
1333,13,192,104,296,92,36,24,10,13,12,2,3,17,0,,
1333,1,235,110,345,131,35,18,13,10,15,15,2,32,0,,
1334,11,204,110,314,77,32,37,11,15,14,14,5,33,0,,
1334,16,180,126,306,72,31,16,15,11,12,10,1,23,0,,
1335,7,178,122,300,75,26,39,20,19,15,8,1,24,0,,
1335,8,197,119,316,108,27,12,19,20,16,13,1,30,0,,
1336,2,166,115,281,68,42,41,25,17,10,10,4,24,0,,
1336,3,190,113,303,68,40,29,17,25,16,19,5,40,0,,
1337,10,175,110,285,70,31,19,20,25,12,7,1,20,0,,
1337,9,207,140,347,88,38,32,25,20,15,17,5,37,0,,
1338,4,138,91,229,49,25,25,18,20,7,6,2,15,0,,
1338,18,213,114,327,104,36,39,20,18,17,13,6,36,0,,
1339,15,183,104,287,79,49,32,18,19,15,7,2,24,0,,
1339,5,195,94,289,81,49,18,19,18,14,8,5,27,0,,
1340,12,199,115,314,95,56,32,23,14,17,6,0,23,0,,
1340,14,183,129,312,64,27,33,14,23,9,9,5,23,0,,
1341,2,173,90,263,74,42,18,22,17,14,5,3,22,0,,
1341,11,191,79,270,78,41,32,17,22,17,14,4,35,0,,
1342,8,242,165,407,132,31,23,16,10,21,9,3,33,0,,
1342,4,168,105,273,73,38,30,10,16,8,7,3,18,0,,
1343,12,240,155,395,113,27,22,22,16,21,10,6,37,0,,
1343,9,185,138,323,92,45,34,16,22,9,11,3,23,0,,
1344,18,197,121,318,86,33,53,11,13,16,13,1,30,0,,
1344,5,192,121,313,84,29,20,13,11,18,10,1,29,0,,
1345,15,196,144,340,68,40,26,9,8,19,22,2,43,0,,
1345,7,164,127,291,73,22,27,8,9,13,10,1,24,0,,
1346,16,187,109,296,77,26,13,28,17,10,12,1,23,0,,
1346,14,221,83,304,134,31,27,17,28,14,10,1,25,0,,
1347,10,187,112,299,95,28,27,14,23,15,10,1,26,0,,
1347,1,193,134,327,77,20,19,23,14,18,13,1,32,0,,
1348,13,207,90,297,94,37,25,16,21,11,8,5,24,0,,
1348,3,192,102,294,90,44,23,21,16,12,9,4,25,0,,
1349,15,201,100,301,77,35,50,22,14,10,8,1,19,0,,
1349,12,206,93,299,80,37,28,14,22,12,9,1,22,0,,
1350,3,206,93,299,101,34,28,17,10,18,12,2,32,0,,
1350,8,198,83,281,116,30,28,10,17,8,7,2,17,0,,
1351,5,162,111,273,61,42,17,16,21,14,12,2,28,0,,
1351,7,154,92,246,60,36,49,21,16,12,6,2,20,0,,
1352,4,186,100,286,65,35,32,23,22,11,7,4,22,0,,
1352,1,208,92,300,77,21,31,22,23,18,13,4,35,0,,
1353,9,167,125,292,80,39,36,16,12,18,13,1,32,0,,
1353,11,187,85,272,73,30,31,12,16,19,10,3,32,0,,
1354,14,201,85,286,110,50,25,22,20,17,13,3,33,0,,
1354,2,152,100,252,58,36,39,20,22,11,9,1,21,0,,
1355,18,206,100,306,90,31,27,14,16,13,8,2,23,0,,
1355,13,196,116,312,86,26,22,16,14,9,11,3,23,0,,
1356,10,187,102,289,71,25,30,19,20,12,9,3,24,0,,
1356,16,166,125,291,71,22,22,20,19,10,2,3,15,0,,
1357,1,172,93,265,71,23,22,21,12,11,11,2,24,0,,
1357,15,204,80,284,93,51,34,12,21,19,7,4,30,0,,
1358,8,201,102,303,106,23,21,12,17,10,11,2,23,0,,
1358,18,229,119,348,103,36,41,17,12,17,11,3,31,0,,
1359,12,203,127,330,96,31,28,19,11,21,19,4,44,0,,
1359,4,148,87,235,67,35,30,11,19,3,9,3,15,0,,
1360,7,178,103,281,78,48,32,13,10,17,8,3,28,0,,
1360,13,191,100,291,87,34,30,10,13,22,10,2,34,0,,
1361,9,204,115,319,107,36,44,16,14,15,10,2,27,0,,
1361,3,165,69,234,71,33,20,14,16,10,11,3,24,0,,
1362,16,196,107,303,90,43,17,15,16,6,9,1,16,0,,
1362,2,188,105,293,86,33,25,16,15,12,10,2,24,0,,
1363,11,197,117,314,85,31,27,16,20,9,10,2,21,0,,
1363,14,181,95,276,89,36,14,20,16,8,7,0,15,0,,
1364,10,184,104,288,84,36,33,22,22,11,3,4,18,0,,
1364,5,188,77,265,87,29,23,22,22,7,12,1,20,0,,
1365,7,192,106,298,85,36,43,14,14,13,5,3,21,0,,
1365,3,211,90,301,95,55,32,14,14,19,12,2,33,0,,
1366,4,188,84,272,62,40,31,15,14,9,5,3,17,0,,
1366,9,193,98,291,61,35,44,14,15,11,16,2,29,0,,
1367,11,184,94,278,37,54,46,18,16,14,12,1,27,0,,
1367,1,201,90,291,48,52,19,16,18,19,11,2,32,0,,
1368,14,205,111,316,109,32,22,19,14,14,5,4,23,0,,
1368,8,204,102,306,109,39,25,14,19,13,11,1,25,0,,
1369,10,211,100,311,93,33,15,11,19,18,13,4,35,0,,
1369,18,196,101,297,95,22,38,19,11,10,15,3,28,0,,
1370,2,205,116,321,105,40,34,15,13,13,6,4,23,0,,
1370,12,184,134,318,86,34,23,13,15,8,12,1,21,0,,
1371,15,233,104,337,97,37,35,19,12,23,11,5,39,0,,
1371,16,176,117,293,66,47,26,12,19,10,6,2,18,0,,
1372,13,147,102,249,60,29,44,14,25,8,7,2,17,0,,
1372,5,205,101,306,93,47,22,25,14,19,19,1,39,0,,
1373,3,178,88,266,64,58,28,16,13,18,11,3,32,0,,
1373,11,150,95,245,43,35,46,13,16,11,4,3,18,0,,
1374,16,196,115,311,88,38,22,17,10,11,10,4,25,0,,
1374,7,177,109,286,83,30,42,10,17,12,14,4,30,0,,
1375,14,185,106,291,85,37,26,17,14,13,8,1,22,0,,
1375,1,188,85,273,81,45,36,14,17,15,4,0,19,0,,
1376,9,197,125,322,103,35,38,13,14,23,7,3,33,0,,
1376,13,179,107,286,74,28,25,14,13,14,11,4,29,0,,
1377,5,203,116,319,78,37,12,23,13,26,15,2,43,0,,
1377,4,152,96,248,58,30,39,13,23,14,6,2,22,0,,
1378,8,205,102,307,97,38,18,12,13,15,10,1,26,0,,
1378,15,175,95,270,67,36,28,13,12,14,9,5,28,0,,
1379,2,186,116,302,94,47,19,22,16,12,11,3,26,0,,
1379,10,190,96,286,95,51,19,16,22,8,10,2,20,0,,
1380,18,154,97,251,51,44,43,20,11,10,9,1,20,0,,
1380,12,190,116,306,90,42,24,11,20,15,11,3,29,0,,
1381,9,211,127,338,68,46,48,17,15,20,16,4,40,0,,
1381,8,188,92,280,79,39,23,15,17,8,5,0,13,0,,
1382,3,220,110,330,101,34,18,15,13,18,7,3,28,0,,
1382,16,208,115,323,109,28,28,13,15,10,8,4,22,0,,
1383,12,212,131,343,108,46,21,14,15,23,13,2,38,0,,
1383,1,191,118,309,89,21,29,15,14,13,11,3,27,0,,
1384,11,192,99,291,70,23,45,18,11,14,12,1,27,0,,
1384,5,189,75,264,67,44,22,11,18,15,5,4,24,0,,
1385,15,223,108,331,104,33,21,12,13,14,7,4,25,0,,
1385,18,198,113,311,94,22,20,13,12,10,10,3,23,0,,
1386,7,165,105,270,83,36,37,12,14,13,6,3,22,0,,
1386,2,192,102,294,88,62,39,14,12,19,12,0,31,0,,
1387,4,199,117,316,80,43,29,25,14,15,5,0,20,0,,
1387,13,172,108,280,68,25,38,14,25,13,7,3,23,0,,
1388,10,156,85,241,60,38,34,19,10,9,7,4,20,0,,
1388,14,197,130,327,105,24,11,10,19,12,8,4,24,0,,
1389,1,170,72,242,65,34,24,25,14,11,10,0,21,0,,
1389,3,230,93,323,123,39,31,14,25,24,9,1,34,0,,
1390,11,176,120,296,69,29,44,13,16,8,13,3,24,0,,
1390,4,192,108,300,72,40,22,16,13,7,7,2,16,0,,
1391,9,189,138,327,85,33,39,7,17,17,14,3,34,0,,
1391,7,166,103,269,73,37,38,17,7,9,7,1,17,0,,
1392,2,185,107,292,85,30,21,23,12,10,10,1,21,0,,
1392,8,203,114,317,93,55,34,12,23,20,5,4,29,0,,
1393,13,203,116,319,95,27,34,13,23,13,12,3,28,0,,
1393,15,199,109,308,72,41,27,23,13,18,9,4,31,0,,
1394,16,190,119,309,81,46,43,29,14,11,3,2,16,0,,
1394,18,231,109,340,101,49,30,14,29,25,8,5,38,0,,
1395,10,188,129,317,91,40,15,13,16,12,14,5,31,0,,
1395,12,166,127,293,75,20,28,16,13,12,5,4,21,0,,
1396,14,195,130,325,84,31,20,14,17,16,15,0,31,0,,
1396,5,158,112,270,60,31,26,17,14,14,6,3,23,0,,
1397,7,161,95,256,79,45,23,12,16,9,5,0,14,0,,
1397,11,211,126,337,93,55,46,16,12,23,14,4,41,0,,
1398,18,200,91,291,92,31,25,24,19,14,8,4,26,0,,
1398,2,175,92,267,86,36,26,19,24,7,10,0,17,0,,
1399,8,175,121,296,71,25,30,13,15,11,10,1,22,0,,
1399,10,196,93,289,86,24,27,15,13,14,9,5,28,0,,
1400,1,203,99,302,105,29,16,15,8,16,20,3,39,0,,
1400,16,183,111,294,105,30,27,8,15,11,16,3,30,0,,
1401,12,214,158,372,92,36,19,20,19,16,12,3,31,0,,
1401,13,194,89,283,77,34,36,19,20,18,7,2,27,0,,
1402,3,203,113,316,110,41,33,22,16,19,10,3,32,0,,
1402,14,177,102,279,82,40,20,16,22,17,8,2,27,0,,
1403,5,197,104,301,86,29,14,26,19,16,3,4,23,0,,
1403,9,195,110,305,69,28,45,19,26,19,12,3,34,0,,
1404,4,195,108,303,67,44,42,15,15,17,7,1,25,0,,
1404,15,204,106,310,70,46,46,15,15,24,7,3,34,0,,
1405,2,225,116,341,113,38,28,24,18,19,11,2,32,0,,
1405,13,186,121,307,77,35,28,18,24,12,11,3,26,0,,
1406,5,189,136,325,85,23,19,19,16,14,4,1,19,0,,
1406,8,215,105,320,95,33,31,16,19,21,12,6,39,0,,
1407,12,230,157,387,119,36,21,9,10,19,15,2,36,0,,
1407,16,176,131,307,96,38,46,10,9,8,7,1,16,0,,
1408,9,185,127,312,91,43,36,14,17,13,14,2,29,0,,
1408,18,177,114,291,85,29,31,17,14,8,10,2,20,0,,
1409,7,181,107,288,95,34,38,15,20,12,4,2,18,0,,
1409,1,210,110,320,110,36,14,20,15,16,13,3,32,0,,
1410,11,184,104,288,80,32,41,17,16,7,12,2,21,0,,
1410,10,192,103,295,79,59,17,16,17,16,8,1,25,0,,
1411,4,162,117,279,68,31,34,18,16,12,4,4,20,0,,
1411,14,180,92,272,79,46,18,16,18,22,16,2,40,0,,
1412,15,186,82,268,64,34,53,11,11,25,8,1,34,0,,
1412,3,190,108,298,71,35,34,11,11,27,8,1,36,0,,
1413,1,198,119,317,86,40,23,10,18,15,10,0,25,0,,
1413,2,198,117,315,104,48,30,18,10,15,7,5,27,0,,
1414,14,185,97,282,98,38,22,18,24,12,5,1,18,0,,
1414,7,191,95,286,99,34,46,24,18,10,5,1,16,0,,
1415,16,189,106,295,75,33,37,21,17,13,9,3,25,0,,
1415,5,187,107,294,87,38,27,17,21,19,4,1,24,0,,
1416,13,194,142,336,100,35,25,15,18,12,11,1,24,0,,
1416,11,200,91,291,101,34,26,18,15,15,7,3,25,0,,
1417,9,177,103,280,72,38,33,14,10,21,9,1,31,0,,
1417,15,171,105,276,67,28,47,10,14,18,4,3,25,0,,
1418,10,210,100,310,55,39,23,23,14,11,11,6,28,0,,
1418,4,205,81,286,68,26,32,14,23,6,7,5,18,0,,
1419,18,217,111,328,89,35,26,16,19,15,12,2,29,0,,
1419,3,204,110,314,102,39,19,19,16,14,8,5,27,0,,
1420,8,212,120,332,99,40,23,24,19,15,2,4,21,0,,
1420,12,212,113,325,91,38,27,19,24,13,10,5,28,0,,
1421,2,164,124,288,78,51,37,17,14,10,7,4,21,0,,
1421,5,163,124,287,70,47,18,14,17,6,12,3,21,0,,
1422,10,234,93,327,109,42,15,17,16,22,10,1,33,0,,
1422,15,157,112,269,49,33,32,16,17,3,13,5,21,0,,
1423,13,174,135,309,64,53,51,15,24,16,7,0,23,0,,
1423,14,169,119,288,68,37,28,24,15,15,9,1,25,0,,
1424,16,198,127,325,97,32,26,17,14,16,7,3,26,0,,
1424,8,178,120,298,76,30,22,14,17,13,7,5,25,0,,
1425,4,207,108,315,75,45,40,14,13,26,13,2,41,0,,
1425,7,168,89,257,80,27,45,13,14,12,6,1,19,0,,
1426,9,204,104,308,101,26,48,23,19,19,16,6,41,0,,
1426,1,180,126,306,74,25,16,19,23,15,9,4,28,0,,
1427,18,176,100,276,67,35,36,18,18,16,10,1,27,0,,
1427,11,182,81,263,77,40,28,18,18,15,8,1,24,0,,
1428,12,202,119,321,81,30,27,18,20,16,6,0,22,0,,
1428,3,176,95,271,63,31,29,20,18,14,8,3,25,0,,
1429,15,202,99,301,87,34,31,15,19,21,4,1,26,0,,
1429,14,183,120,303,85,45,23,19,15,12,7,3,22,0,,
1430,11,212,119,331,65,37,40,14,22,16,5,5,26,0,,
1430,12,165,84,249,72,47,36,22,14,8,4,1,13,0,,
1431,7,203,130,333,99,40,33,13,17,16,15,3,34,0,,
1431,18,192,113,305,90,30,30,17,13,19,10,1,30,0,,
1432,13,170,107,277,80,41,24,13,14,10,9,2,21,0,,
1432,8,184,142,326,82,48,28,14,13,24,10,2,36,0,,
1433,3,205,128,333,88,35,37,21,11,11,9,4,24,0,,
1433,10,189,101,290,85,42,25,11,21,11,9,2,22,0,,
1434,5,224,134,358,104,47,26,15,6,17,14,3,34,0,,
1434,1,164,123,287,77,45,15,6,15,11,11,0,22,0,,
1435,9,191,113,304,91,36,34,11,18,19,11,3,33,0,,
1435,2,161,134,295,59,21,39,18,11,15,4,3,22,0,,
1436,4,183,98,281,66,46,44,22,19,14,13,1,28,0,,
1436,16,165,113,278,71,59,29,19,22,9,7,3,19,0,,
1437,11,208,93,301,80,27,37,11,8,25,9,3,37,0,,
1437,15,170,92,262,58,52,50,8,11,15,8,2,25,0,,
1438,5,193,146,339,81,39,14,18,17,13,9,0,22,0,,
1438,3,199,108,307,76,51,30,17,18,15,10,7,32,0,,
1439,18,212,111,323,85,31,46,20,14,14,12,3,29,0,,
1439,14,175,103,278,104,32,15,14,20,10,4,5,19,0,,
1440,2,193,129,322,89,29,42,15,9,20,16,2,38,0,,
1440,4,171,108,279,66,33,23,9,15,10,11,2,23,0,,
1441,16,176,131,307,97,36,25,16,10,12,14,1,27,0,,
1441,9,191,136,327,95,22,33,10,16,21,8,4,33,0,,
1442,10,170,105,275,66,44,32,13,14,14,11,3,28,0,,
1442,13,184,103,287,85,26,31,14,13,19,15,2,36,0,,
1443,8,179,122,301,95,59,21,14,26,12,7,0,19,0,,
1443,1,215,150,365,81,33,22,26,14,17,21,2,40,0,,
1444,7,193,124,317,97,23,45,15,14,16,8,0,24,0,,
1444,12,204,110,314,106,37,25,14,15,22,14,2,38,0,,
1445,2,195,110,305,95,26,29,18,17,13,12,2,27,0,,
1445,15,176,70,246,71,36,27,17,18,13,9,1,23,0,,
1446,1,170,122,292,88,40,14,15,13,10,11,2,23,0,,
1446,18,211,114,325,100,46,28,13,15,22,14,4,40,0,,
1447,4,184,91,275,77,38,37,16,17,6,6,5,17,0,,
1447,3,241,147,388,107,26,16,17,16,21,8,2,31,0,,
1448,5,149,116,265,66,30,29,14,15,9,8,0,17,0,,
1448,12,185,106,291,72,48,50,15,14,20,9,1,30,0,,
1449,14,152,105,257,42,40,49,18,15,9,10,3,22,0,,
1449,9,180,119,299,65,58,34,15,18,16,11,3,30,0,,
1450,11,216,121,337,60,56,51,19,20,13,10,3,26,0,,
1450,8,165,91,256,43,60,27,20,19,8,5,0,13,0,,
1451,10,207,99,306,75,31,20,20,13,21,15,1,37,0,,
1451,7,179,106,285,80,29,44,13,20,8,7,0,15,0,,
1452,13,194,111,305,79,40,32,15,17,16,15,3,34,0,,
1452,16,168,103,271,81,34,33,17,15,12,6,1,19,0,,
1453,2,190,127,317,90,40,27,17,15,17,4,1,22,0,,
1453,3,191,103,294,89,52,22,15,17,12,11,0,23,0,,
1454,8,204,118,322,98,28,32,11,17,13,9,0,22,0,,
1454,7,206,130,336,104,26,28,17,11,13,10,1,24,0,,
1455,12,211,126,337,86,56,33,25,11,13,17,2,32,0,,
1455,14,154,91,245,53,37,48,11,25,3,7,2,12,0,,
1456,9,198,124,322,81,46,47,12,17,13,11,4,28,0,,
1456,10,188,82,270,75,45,33,17,12,9,6,2,17,0,,
1457,16,209,123,332,65,35,25,19,13,17,15,3,35,0,,
1457,11,208,108,316,68,35,49,13,19,11,12,5,28,0,,
1458,18,229,130,359,108,38,25,13,12,24,16,3,43,0,,
1458,4,182,109,291,82,28,36,12,13,7,8,1,16,0,,
1459,1,174,99,273,65,35,17,23,14,19,9,0,28,0,,
1459,13,221,93,314,112,39,36,14,23,21,5,2,28,0,,
1460,5,203,131,334,108,23,16,13,17,19,9,3,31,0,,
1460,15,179,111,290,62,26,34,17,13,11,16,1,28,0,,
1461,3,216,112,328,107,52,15,16,14,17,10,1,28,0,,
1461,2,168,118,286,80,33,28,14,16,5,8,5,18,0,,
1462,12,203,156,359,87,54,32,13,13,17,13,3,33,0,,
1462,11,179,91,270,66,36,27,13,13,6,12,2,20,0,,
1463,9,200,111,311,94,35,34,21,17,12,12,4,28,0,,
1463,18,205,95,300,92,29,33,17,21,8,5,3,16,0,,
1464,8,199,113,312,92,47,31,20,19,19,13,2,34,0,,
1464,10,173,101,274,64,30,32,19,20,11,5,3,19,0,,
1465,8,192,111,303,102,54,19,13,14,10,9,3,22,0,,
1465,18,177,118,295,76,31,25,14,13,10,8,1,19,0,,
1466,2,185,144,329,83,42,38,17,31,10,6,1,17,0,,
1466,12,177,100,277,70,53,26,31,17,7,14,0,21,0,,
1467,9,207,120,327,108,34,33,20,14,20,15,1,36,0,,
1467,2,178,144,322,84,22,25,14,20,10,4,4,18,0,,
1468,3,174,100,274,81,41,14,15,23,11,10,0,21,0,,
1468,8,179,96,275,85,44,24,23,15,9,10,3,22,0,,
1469,9,176,78,254,73,34,39,22,19,15,17,1,33,0,,
1469,3,165,90,255,60,54,26,19,22,12,7,3,22,0,,
1470,2,186,74,260,84,29,34,17,11,24,9,2,35,0,,
1470,5,161,99,260,73,36,27,11,17,18,7,3,28,0,,
1471,18,190,101,291,86,43,36,12,11,11,5,2,18,0,,
1471,15,182,80,262,74,46,28,11,12,12,9,2,23,0,,
1472,7,175,93,268,80,46,31,23,18,14,3,2,19,0,,
1472,12,157,90,247,71,44,28,18,23,10,4,1,15,0,,
1473,3,247,152,399,122,33,20,9,10,18,15,3,36,0,,
1473,14,195,140,335,86,28,34,10,9,11,8,2,21,0,,
1474,10,176,111,287,57,50,44,15,8,12,13,2,27,0,,
1474,9,180,117,297,69,32,39,8,15,17,6,2,25,0,,
1475,4,199,132,331,86,23,42,14,15,21,10,1,32,0,,
1475,16,202,145,347,71,39,22,15,14,18,9,1,28,0,,
1476,1,184,125,309,82,48,17,16,8,12,18,3,33,0,,
1476,11,178,127,305,84,43,41,8,16,16,12,4,32,0,,
1477,8,165,79,244,67,50,24,14,14,15,9,4,28,0,,
1477,13,178,106,284,82,50,37,14,14,20,8,1,29,0,,
1478,2,202,100,302,100,37,25,17,11,8,8,4,20,0,,
1478,3,217,119,336,103,45,30,11,17,16,12,4,32,0,,
1479,5,193,119,312,90,35,35,16,11,17,15,3,35,0,,
1479,4,174,96,270,57,37,36,11,16,18,11,0,29,0,,
1480,12,168,117,285,66,29,23,18,14,4,6,3,13,0,,
1480,10,205,127,332,96,48,40,14,18,17,6,3,26,0,,
1481,11,193,101,294,72,50,32,15,14,16,12,2,30,0,,
1481,14,151,105,256,52,44,27,14,15,12,6,1,19,0,,
1482,15,215,92,307,79,31,34,10,13,16,12,2,30,0,,
1482,1,203,90,293,94,33,11,13,10,14,12,1,27,0,,
1483,13,203,113,316,115,43,18,15,17,16,10,3,29,0,,
1483,18,157,97,254,78,35,32,17,15,11,11,5,27,0,,
1484,16,160,136,296,73,37,18,19,20,10,15,1,26,0,,
1484,7,196,87,283,110,44,24,20,19,11,7,0,18,0,,
1485,9,200,96,296,83,28,35,20,19,21,14,8,43,0,,
1485,8,166,87,253,78,44,27,19,20,6,8,2,16,0,,
1486,5,167,71,238,49,59,34,21,22,7,12,1,20,0,,
1486,12,161,98,259,60,69,41,22,21,11,5,4,20,0,,
1487,11,171,98,269,68,38,42,16,17,17,12,0,29,0,,
1487,10,134,116,250,50,59,28,17,16,13,4,2,19,0,,
1488,2,212,112,324,97,40,32,16,14,13,14,4,31,0,,
1488,13,189,99,288,96,38,42,14,16,11,10,0,21,0,,
1489,15,191,91,282,81,64,38,9,18,10,6,1,17,0,,
1489,14,185,98,283,69,50,38,18,9,11,7,2,20,0,,
1490,9,211,108,319,80,40,29,19,13,17,13,2,32,0,,
1490,3,180,131,311,75,39,17,13,19,9,10,3,22,0,,
1491,7,167,105,272,81,46,29,17,17,8,6,2,16,0,,
1491,18,206,93,299,100,40,27,17,17,20,17,2,39,0,,
1492,4,183,110,293,68,38,29,12,17,17,9,2,28,0,,
1492,1,181,109,290,55,34,26,17,12,11,15,0,26,0,,
1493,8,166,92,258,59,47,22,14,25,13,7,4,24,0,,
1493,16,188,109,297,91,32,32,25,14,11,12,1,24,0,,
1494,3,186,103,289,80,60,28,21,9,19,7,1,27,0,,
1494,11,180,125,305,76,37,49,9,21,11,12,3,26,0,,
1495,1,202,127,329,99,28,18,23,10,12,4,2,18,0,,
1495,9,176,108,284,99,60,40,10,23,14,8,2,24,0,,
1496,5,187,102,289,82,32,23,14,17,15,13,1,29,0,,
1496,8,184,99,283,81,33,21,17,14,9,6,3,18,0,,
1497,10,191,113,304,71,25,21,15,17,15,10,3,28,0,,
1497,15,178,105,283,59,37,33,17,15,14,13,3,30,0,,
1498,13,191,139,330,87,57,41,17,16,21,11,0,32,0,,
1498,4,159,85,244,42,52,35,16,17,15,7,6,28,0,,
1499,14,197,138,335,79,55,33,12,15,26,10,0,36,0,,
1499,7,130,115,245,51,43,35,15,12,6,7,1,14,0,,
1500,16,232,121,353,105,31,31,22,14,21,12,0,33,0,,
1500,2,189,136,325,87,25,25,14,22,11,4,2,17,0,,
1501,18,217,144,361,97,31,43,24,16,23,8,2,33,0,,
1501,12,187,128,315,94,41,25,16,24,14,7,4,25,0,,
1502,5,200,66,266,70,55,38,18,14,9,9,3,21,0,,
1502,3,199,98,297,59,46,34,14,18,4,8,1,13,0,,
1503,1,188,142,330,85,41,19,19,13,10,18,3,31,0,,
1503,13,196,89,285,101,54,30,13,19,15,12,2,29,0,,
1504,4,192,97,289,77,44,42,13,12,18,11,2,31,0,,
1504,9,160,104,264,65,38,32,12,13,10,12,3,25,0,,
1505,7,192,119,311,96,46,25,14,13,8,6,2,16,0,,
1506,8,185,109,294,65,64,41,9,14,19,6,5,30,0,,
1506,2,168,127,295,70,59,38,14,9,12,6,5,23,0,,
1507,11,160,96,256,53,50,39,14,15,12,8,2,22,0,,
1507,18,158,95,253,68,47,39,15,14,14,2,4,20,0,,
1508,14,186,106,292,72,36,21,17,19,17,9,0,26,0,,
1508,16,203,97,300,93,53,23,19,17,6,12,1,19,0,,
1509,15,208,112,320,75,28,38,15,12,19,15,2,36,0,,
1509,12,189,113,302,92,32,28,12,15,17,8,2,27,0,,
1510,7,166,96,262,97,27,25,15,23,3,6,4,13,0,,
1510,5,230,105,335,125,38,23,23,15,16,13,2,31,0,,
1511,8,237,138,375,123,46,27,13,13,24,9,2,35,0,,
1511,15,176,108,284,58,36,44,13,13,13,9,0,22,0,,
1512,9,210,131,341,97,48,42,9,10,21,16,4,41,0,,
1512,14,176,102,278,74,46,28,10,9,13,9,2,24,0,,
1513,16,230,119,349,139,31,25,15,15,13,10,1,24,0,,
1513,3,176,102,278,83,30,12,15,15,9,6,2,17,0,,
1514,1,183,125,308,88,31,20,16,15,14,12,0,26,0,,
1514,12,169,135,304,74,50,25,15,16,9,11,3,23,0,,
1515,18,209,161,370,99,23,41,11,10,20,10,3,33,0,,
1515,4,171,107,278,62,56,28,10,11,11,10,3,24,0,,
1516,10,165,107,272,66,42,32,15,14,15,8,1,24,0,,
1516,13,159,110,269,63,29,32,14,15,10,9,2,21,0,,
1517,11,196,131,327,78,58,33,14,10,14,16,5,35,0,,
1517,2,164,109,273,79,48,28,10,14,11,6,1,18,0,,
1518,3,203,100,303,95,57,34,7,18,12,13,2,27,0,,
1518,12,170,126,296,70,45,22,18,7,9,6,2,17,0,,
1519,11,187,146,333,67,43,42,15,13,18,8,2,28,0,,
1519,16,169,140,309,66,37,21,13,15,13,11,0,24,0,,
1520,4,217,117,334,83,27,14,16,19,21,12,1,34,0,,
1520,15,183,68,251,67,39,44,19,16,13,10,2,25,0,,
1521,8,193,136,329,88,38,36,11,15,20,8,2,30,0,,
1521,14,186,91,277,80,51,37,15,11,11,9,3,23,0,,
1522,2,180,124,304,74,41,42,14,9,13,5,5,23,0,,
1522,10,163,77,240,65,53,30,9,14,12,7,3,22,0,,
1523,13,169,128,297,64,42,36,15,12,15,11,4,30,0,,
1523,7,199,92,291,103,45,31,12,15,15,12,0,27,0,,
1524,9,182,137,319,67,36,43,21,19,19,11,4,34,0,,
1524,18,183,104,287,78,27,28,19,21,11,3,3,17,0,,
1525,1,173,110,283,72,36,21,16,13,8,14,1,23,0,,
1525,5,184,111,295,103,39,27,13,16,11,5,2,18,0,,
1526,8,186,132,318,72,48,25,15,19,12,16,1,29,0,,
1526,12,172,118,290,74,53,38,19,15,12,7,1,20,0,,
1527,2,194,132,326,79,33,30,17,16,13,13,3,29,0,,
1527,4,161,93,254,63,56,19,16,17,10,10,3,23,0,,
1528,16,171,119,290,73,44,18,13,12,14,8,2,24,0,,
1528,13,188,106,294,84,26,35,12,13,13,9,2,24,0,,
1529,18,206,126,332,77,49,40,21,18,20,9,0,29,0,,
1529,14,148,137,285,60,30,26,18,21,7,8,4,19,0,,
1530,5,202,114,316,88,37,27,17,16,17,10,2,29,0,,
1530,9,164,117,281,76,42,46,16,17,16,12,3,31,0,,
1531,3,219,117,336,120,36,29,10,15,26,14,1,41,0,,
1531,7,186,87,273,96,28,25,15,10,11,6,0,17,0,,
1532,10,171,121,292,50,48,22,8,11,11,14,10,35,0,,
1532,1,205,112,317,104,26,30,11,8,24,14,1,39,0,,
1533,15,187,85,272,71,37,32,21,15,16,11,3,30,0,,
1533,11,189,123,312,67,35,30,15,21,14,7,2,23,0,,
1534,18,164,99,263,86,21,36,19,13,14,5,2,21,0,,
1534,5,155,94,249,72,44,27,13,19,12,10,4,26,0,,
1535,13,192,93,285,85,46,34,15,7,17,8,1,26,0,,
1535,15,185,77,262,59,45,39,7,15,15,17,0,32,0,,
1536,7,171,118,289,80,31,26,23,17,10,9,3,22,0,,
1536,2,165,104,269,88,41,35,17,23,9,7,2,18,0,,
1537,14,171,118,289,58,55,32,10,14,17,3,0,20,0,,
1537,1,200,125,325,96,38,23,14,10,18,7,2,27,0,,
1538,10,194,106,300,73,50,22,17,14,11,12,5,28,0,,
1538,3,190,73,263,94,30,31,14,17,12,9,4,25,0,,
1539,4,184,103,287,58,45,35,22,21,19,9,3,31,0,,
1539,8,161,81,242,52,53,30,21,22,14,3,1,18,0,,
1540,9,197,142,339,91,37,30,14,16,16,10,3,29,0,,
1540,16,196,123,319,108,29,20,16,14,11,12,1,24,0,,
1541,12,163,105,268,73,42,35,17,17,11,9,0,20,0,,
1541,11,192,127,319,78,36,40,17,17,20,7,4,31,0,,
1542,15,206,72,278,72,45,40,15,9,12,16,4,32,0,,
1542,3,205,105,310,82,41,21,9,15,12,11,1,24,0,,
1543,14,173,84,257,77,41,30,14,16,12,15,2,29,0,,
1543,13,169,91,260,82,35,31,16,14,9,7,2,18,0,,
1544,11,195,109,304,71,44,30,11,12,15,10,1,26,0,,
1544,9,171,90,261,61,61,31,12,11,14,8,2,24,0,,
1545,2,164,105,269,70,43,30,18,17,14,13,1,28,0,,
1545,1,178,106,284,86,34,21,17,18,17,14,1,32,0,,
1546,5,192,111,303,80,42,29,20,16,14,9,2,25,0,,
1546,10,168,96,264,63,53,33,16,20,12,8,4,24,0,,
1547,7,183,112,295,74,43,50,15,10,20,7,0,27,0,,
1547,4,174,91,265,72,51,35,10,15,11,7,4,22,0,,
1548,16,196,127,323,72,56,38,18,13,14,10,2,26,0,,
1548,12,196,118,314,68,49,19,13,18,10,7,1,18,0,,
1549,18,186,155,341,86,23,33,19,13,17,13,2,32,0,,
1549,8,153,124,277,69,31,19,13,19,12,3,2,17,0,,
1550,15,183,87,270,67,48,41,7,8,14,10,1,25,0,,
1550,2,209,138,347,95,46,10,8,7,11,16,2,29,0,,
1551,3,155,58,213,76,53,26,24,25,7,6,1,14,0,,
1551,18,189,105,294,85,47,26,25,24,16,8,4,28,0,,
1552,11,218,110,328,80,33,29,16,17,14,12,6,32,0,,
1552,8,170,96,266,69,51,29,17,16,8,9,1,18,0,,
1553,4,190,119,309,68,37,38,18,16,15,9,3,27,0,,
1553,10,182,98,280,71,38,41,16,18,13,10,1,24,0,,
1554,9,216,105,321,101,55,33,11,18,16,15,2,33,0,,
1554,7,170,111,281,71,45,29,18,11,7,8,2,17,0,,
1555,1,200,152,352,86,32,19,17,15,22,10,3,35,0,,
1555,16,172,131,303,87,43,21,15,17,12,7,1,20,0,,
1556,14,171,126,297,68,33,41,21,19,15,8,2,25,0,,
1556,12,179,95,274,81,43,30,19,21,14,11,1,26,0,,
1557,13,202,104,306,91,34,39,14,22,10,12,3,25,0,,
1557,5,200,139,339,76,29,16,22,14,19,11,1,31,0,,
1558,8,192,112,304,92,46,29,17,17,10,5,0,15,0,,
1558,3,183,90,273,56,44,31,17,17,10,9,3,22,0,,
1559,12,192,120,312,102,58,17,10,12,12,12,4,28,0,,
1559,4,155,116,271,51,43,42,12,10,12,9,8,29,0,,
1560,10,154,101,255,41,49,46,15,17,15,8,1,24,0,,
1560,14,175,108,283,65,24,44,17,15,15,9,2,26,0,,
1561,16,183,123,306,60,54,30,20,13,12,17,1,30,0,,
1561,5,170,132,302,70,37,23,13,20,12,4,3,19,0,,
1562,1,219,112,331,107,37,16,18,10,19,17,2,38,0,,
1562,7,184,95,279,89,30,33,10,18,13,6,2,21,0,,
1563,9,192,88,280,90,49,34,14,16,20,15,3,38,0,,
1563,15,166,94,260,72,25,40,16,14,19,8,1,28,0,,
1564,13,207,97,304,87,44,36,21,16,14,11,3,28,0,,
1564,11,185,114,299,79,33,28,16,21,10,12,1,23,0,,
1565,18,234,109,343,110,52,46,16,12,23,13,3,39,0,,
1565,2,161,128,289,67,42,17,12,16,10,10,0,20,0,,
1566,3,215,92,307,113,49,21,13,11,18,10,2,30,0,,
1566,13,207,95,302,80,37,41,11,13,16,10,2,28,0,,
1567,2,158,104,262,81,46,34,12,15,7,10,2,19,0,,
1567,14,191,97,288,82,49,26,15,12,14,10,2,26,0,,
1568,18,226,132,358,102,36,33,12,15,25,10,1,36,0,,
1568,1,185,115,300,86,37,19,15,12,18,6,1,25,0,,
1569,15,176,108,284,72,32,43,18,13,8,12,0,20,0,,
1569,5,189,113,302,68,40,18,13,18,13,12,3,28,0,,
1570,9,181,97,278,75,38,40,17,25,19,8,2,29,0,,
1570,12,176,104,280,75,34,19,25,17,16,12,1,29,0,,
1571,7,167,98,265,85,45,43,10,11,11,10,2,23,0,,
1571,8,177,153,330,81,52,30,11,10,13,8,1,22,0,,
1572,10,182,139,321,68,34,37,18,10,20,14,5,39,0,,
1572,16,163,128,291,75,27,19,10,18,9,8,0,17,0,,
1573,4,188,119,307,74,53,25,17,14,20,12,3,35,0,,
1573,11,178,134,312,61,35,45,14,17,18,7,2,27,0,,
1574,2,160,117,277,58,50,31,14,17,12,11,2,25,0,,
1574,12,170,93,263,75,58,29,17,14,13,8,0,21,0,,
1575,8,175,136,311,66,51,31,16,14,11,6,2,19,0,,
1575,10,162,123,285,62,52,35,14,16,9,7,3,19,0,,
1576,14,175,107,282,60,58,26,20,21,8,15,2,25,0,,
1576,4,155,95,250,43,48,51,21,20,4,7,2,13,0,,
1577,16,174,84,258,100,44,30,17,17,9,7,2,18,0,,
1577,18,195,136,331,69,31,34,17,17,22,14,1,37,0,,
1578,1,203,95,298,122,31,18,15,13,18,9,1,28,0,,
1579,11,176,131,307,63,42,47,21,12,17,9,5,31,0,,
1579,5,162,76,238,52,45,24,12,21,21,11,1,33,0,,
1580,7,174,129,303,75,44,29,11,11,13,5,1,19,0,,
1580,15,199,94,293,91,56,47,11,11,20,6,2,28,0,,
1581,9,174,102,276,81,40,37,14,11,16,11,3,30,0,,
1581,13,193,128,321,92,34,38,11,14,20,10,1,31,0,,
1582,1,183,107,290,84,38,28,13,11,14,8,1,23,0,,
1582,8,209,115,324,106,47,31,11,13,17,12,2,31,0,,
1583,5,178,123,301,58,31,24,10,9,15,9,0,24,0,,
1583,14,183,111,294,62,53,36,9,10,19,11,2,32,0,,
1584,11,178,108,286,75,48,37,16,21,15,7,2,24,0,,
1584,7,158,91,249,56,53,40,21,16,12,7,2,21,0,,
1585,9,200,104,304,103,64,36,15,24,18,9,1,28,0,,
1585,2,176,136,312,78,35,31,24,15,7,9,4,20,0,,
1586,15,179,74,253,61,35,33,13,10,12,9,2,23,0,,
1586,16,195,111,306,99,36,14,10,13,12,9,1,22,0,,
1587,10,184,110,294,86,44,28,13,15,13,11,3,27,0,,
1587,18,178,113,291,88,26,39,15,13,14,8,2,24,0,,
1588,4,204,95,299,75,53,40,19,15,13,9,3,25,0,,
1588,3,192,116,308,72,60,16,15,19,8,10,5,23,0,,
1589,13,198,104,302,96,30,45,20,19,21,12,1,34,0,,
1589,12,165,94,259,82,35,26,19,20,14,8,3,25,0,,
1590,5,167,105,272,63,68,35,20,19,13,10,1,24,0,,
1590,2,165,103,268,64,44,34,19,20,7,5,2,14,0,,
1591,16,207,101,308,109,37,29,14,16,15,10,0,25,0,,
1591,4,168,89,257,72,27,29,16,14,11,1,3,15,0,,
1592,3,188,85,273,80,42,30,17,14,8,7,1,16,0,,
1592,14,192,111,303,81,46,28,14,17,14,10,1,25,0,,
1593,13,174,116,290,65,37,34,15,15,9,9,4,22,0,,
1593,8,206,115,321,88,35,25,15,15,14,9,0,23,0,,
1594,15,180,55,235,56,71,40,18,20,14,12,3,29,0,,
1594,18,156,78,234,58,37,42,20,18,10,7,3,20,0,,
1595,11,201,109,310,81,29,43,13,14,21,9,3,33,0,,
1595,1,174,106,280,84,38,15,14,13,14,10,1,25,0,,
1596,9,201,96,297,92,35,39,12,11,17,13,2,32,0,,
1596,10,169,120,289,78,37,33,11,12,12,3,4,19,0,,
1597,7,182,109,291,80,40,37,19,8,22,6,2,30,0,,
1597,12,177,126,303,90,40,27,8,19,14,9,4,27,0,,
1598,2,220,123,343,121,46,29,9,13,7,9,2,18,0,,
1598,3,202,148,350,97,38,16,13,9,7,10,2,19,0,,
1599,8,180,117,297,76,35,22,16,13,10,6,2,18,0,,
1599,9,205,92,297,104,45,36,13,16,18,14,2,34,0,,
1600,18,188,86,274,62,41,36,18,15,17,10,4,31,0,,
1600,13,175,103,278,77,45,31,15,18,17,8,2,27,0,,
1601,4,202,110,312,98,51,60,18,9,17,9,3,29,0,,
1601,5,174,111,285,62,47,26,9,18,8,6,2,16,0,,
1602,10,177,129,306,89,50,41,16,12,13,12,2,27,0,,
1602,12,155,117,272,68,40,30,12,16,10,7,2,19,0,,
1603,1,207,135,342,92,59,30,16,9,21,13,0,34,0,,
1603,15,162,99,261,56,38,37,9,16,16,9,0,25,0,,
1604,14,171,132,303,60,48,33,16,9,12,16,2,30,0,,
1604,11,169,121,290,66,53,50,9,16,15,3,0,18,0,,
1605,7,185,127,312,76,34,21,18,16,18,10,0,28,0,,
1605,16,198,144,342,98,31,27,16,18,11,11,2,24,0,,
1606,5,203,105,308,87,55,37,24,18,21,11,4,36,0,,
1606,12,157,93,250,84,41,28,18,24,4,8,1,13,0,,
1607,18,182,96,278,74,41,50,10,14,16,6,3,25,0,,
1607,7,177,85,262,81,54,37,14,10,9,9,0,18,0,,
1608,14,158,110,268,70,48,26,20,18,7,6,3,16,0,,
1608,15,187,68,255,71,48,44,18,20,17,12,1,30,0,,
1609,16,206,115,321,96,37,30,21,24,14,10,2,26,0,,
1609,8,191,87,278,71,42,25,24,21,4,11,0,15,0,,
1610,3,184,102,286,84,50,31,11,20,11,3,2,16,0,,
1610,9,193,106,299,96,54,38,20,11,16,10,2,28,0,,
1611,13,165,104,269,73,60,36,13,15,14,8,2,24,0,,
1611,2,183,112,295,79,60,37,15,13,14,13,2,29,0,,
1612,10,155,117,272,66,54,24,19,12,15,7,1,23,0,,
1612,11,204,124,328,71,35,29,12,19,17,11,3,31,0,,
1613,1,205,127,332,91,32,22,16,9,22,9,1,32,0,,
1613,4,167,117,284,73,37,41,9,16,14,6,1,21,0,,
1614,8,193,96,289,82,54,40,13,19,15,11,4,30,0,,
1614,5,178,106,284,60,30,22,19,13,14,10,3,27,0,,
1615,12,159,117,276,71,56,23,17,13,5,13,2,20,0,,
1615,18,162,93,255,68,58,37,13,17,7,7,5,19,0,,
1616,10,194,136,330,78,61,21,5,8,22,9,3,34,0,,
1616,15,163,80,243,64,34,38,8,5,15,7,0,22,0,,
1617,2,189,149,338,77,40,28,15,12,18,13,1,32,0,,
1617,16,163,122,285,71,56,22,12,15,10,9,3,22,0,,
1618,9,185,130,315,93,36,34,11,15,14,17,4,35,0,,
1618,1,184,103,287,106,28,20,15,11,9,11,2,22,0,,
1619,11,210,133,343,78,55,42,24,14,18,13,3,34,0,,
1619,3,165,110,275,64,41,21,14,24,11,10,0,21,0,,
1620,4,190,113,303,76,25,25,13,13,15,9,1,25,0,,
1620,13,207,130,337,88,34,37,13,13,15,14,2,31,0,,
1621,7,184,148,332,74,34,57,21,11,15,11,0,26,0,,
1621,14,172,92,264,61,44,27,11,21,16,4,2,22,0,,
1622,2,176,95,271,87,38,46,16,14,16,11,0,27,0,,
1622,8,182,135,317,89,45,21,14,16,13,13,2,28,0,,
1623,16,192,144,336,85,60,36,11,18,17,13,2,32,0,,
1623,14,166,117,283,59,37,22,18,11,11,6,0,17,0,,
1624,5,172,75,247,70,32,28,21,12,10,10,1,21,0,,
1624,3,222,130,352,100,37,37,12,21,19,8,4,31,0,,
1625,9,198,132,330,102,42,34,11,17,20,15,1,36,0,,
1625,4,175,86,261,88,40,29,17,11,13,7,4,24,0,,
1626,15,162,95,257,59,63,49,11,11,17,12,0,29,0,,
1626,12,153,134,287,72,49,25,11,11,15,5,0,20,0,,
1627,10,174,119,293,69,51,16,13,13,12,14,1,27,0,,
1627,7,168,114,282,67,30,48,13,13,12,8,0,20,0,,
1628,13,188,119,307,92,37,31,6,11,15,14,3,32,0,,
1628,1,182,131,313,85,29,18,11,6,14,6,5,25,0,,
1629,18,166,91,257,75,61,43,16,12,12,8,4,24,0,,
1629,11,144,118,262,52,55,34,12,16,11,8,2,21,0,,
1630,8,169,111,280,79,53,31,12,17,16,6,2,24,0,,
1630,15,189,106,295,58,38,38,17,12,17,13,4,34,0,,
1631,13,182,133,315,77,50,50,21,8,11,6,5,22,0,,
1631,10,172,122,294,72,47,29,8,21,23,5,2,30,0,,
1632,14,191,110,301,81,33,25,14,15,7,11,2,20,0,,
1632,9,206,112,318,107,37,35,15,14,16,12,2,30,0,,
1633,4,165,85,250,48,43,36,20,17,10,4,1,15,0,,
1633,18,205,87,292,66,45,57,17,20,14,14,5,33,0,,
1634,1,152,114,266,70,45,31,12,13,14,11,2,27,0,,
1634,12,193,110,303,96,42,23,13,12,15,8,1,24,0,,
1635,3,203,116,319,82,29,11,23,23,13,12,3,28,0,,
1635,16,191,119,310,91,37,32,23,23,10,12,0,22,0,,
1636,5,190,82,272,93,50,32,19,12,11,9,2,22,0,,
1636,7,190,152,342,81,36,33,12,19,9,10,2,21,0,,
1637,11,186,92,278,103,52,34,11,15,13,8,1,22,0,,
1637,2,168,93,261,78,44,32,15,11,9,11,0,20,0,,
1638,8,185,112,297,75,65,42,23,19,11,8,1,20,0,,
1638,14,199,93,292,83,52,24,19,23,8,7,2,17,0,,
1639,18,185,105,290,71,44,37,18,11,13,11,1,25,0,,
1639,9,182,107,289,79,53,37,11,18,13,5,1,19,0,,
1640,5,184,104,288,84,49,16,10,9,10,12,1,23,0,,
1640,1,202,123,325,108,36,25,9,10,17,12,0,29,0,,
1641,10,189,132,321,94,48,21,8,22,17,13,1,31,0,,
1641,2,194,110,304,101,26,27,22,8,11,10,0,21,0,,
1642,7,174,132,306,68,35,30,17,11,18,7,2,27,0,,
1642,13,196,98,294,107,41,38,11,17,20,13,2,35,0,,
1643,16,151,132,283,46,55,28,19,18,12,7,1,20,0,,
1643,11,210,133,343,68,42,38,18,19,17,16,2,35,0,,
1644,4,170,102,272,63,52,54,9,9,22,11,0,33,0,,
1644,15,179,101,280,59,74,28,9,9,18,15,3,36,0,,
1645,3,212,126,338,104,35,33,12,13,12,16,4,32,0,,
1645,12,174,141,315,89,37,16,13,12,5,5,2,12,0,,
1646,5,191,96,287,76,46,21,11,8,16,11,1,28,0,,
1646,18,180,84,264,73,59,43,8,11,14,10,1,25,0,,
1647,3,225,141,366,100,51,44,6,10,17,8,1,26,0,,
1647,4,174,98,272,57,58,32,10,6,11,10,2,23,0,,
1648,9,199,104,303,88,69,38,12,16,17,11,2,30,0,,
1648,11,178,111,289,59,47,41,16,12,5,10,4,19,0,,
1649,13,188,127,315,78,51,40,13,13,18,12,2,32,0,,
1649,15,183,100,283,59,38,34,13,13,11,15,3,29,0,,
1650,18,218,93,311,103,36,22,17,11,11,17,0,28,0,,
1650,3,182,110,292,79,50,28,11,17,8,10,1,19,0,,
1651,11,162,104,266,68,45,39,14,18,20,10,0,30,0,,
1651,13,157,63,220,72,47,31,18,14,17,10,6,33,0,,
1652,5,191,99,290,80,68,27,16,20,13,12,1,26,0,,
1652,11,177,113,290,63,57,46,20,16,9,6,3,18,0,,
1653,9,199,103,302,88,60,42,11,11,21,9,3,33,0,,
1653,18,164,99,263,61,50,39,11,11,12,7,3,22,0,,
1654,9,198,83,281,87,44,48,16,24,10,11,4,25,0,,
1654,5,193,79,272,64,73,27,24,16,9,8,4,21,0,,
1655,5,190,99,289,93,45,19,16,29,13,12,4,29,0,,
1655,2,185,107,292,83,42,32,29,16,8,15,3,26,0,,
1656,4,218,117,335,82,42,27,30,16,17,15,5,37,0,,
1656,18,173,82,255,83,50,28,16,30,11,7,1,19,0,,
1657,9,213,88,301,94,30,33,18,20,14,18,2,34,0,,
1657,3,222,102,324,109,37,26,20,18,8,9,4,21,0,,
1658,10,218,94,312,102,37,29,19,22,22,11,3,36,0,,
1658,12,162,60,222,48,22,12,22,19,10,9,3,22,0,,
1659,15,198,106,304,87,35,29,11,10,14,11,1,26,0,,
1659,7,206,129,335,110,36,28,10,11,10,7,3,20,0,,
1660,1,235,143,378,103,44,28,19,11,19,14,2,35,0,,
1660,14,186,101,287,81,46,31,11,19,13,12,1,26,0,,
1661,11,183,152,335,76,35,27,19,19,22,12,1,35,0,,
1661,16,169,95,264,70,58,33,19,19,13,7,4,24,0,,
1662,13,198,113,311,92,29,21,19,19,16,9,1,26,0,,
1662,8,190,79,269,80,43,44,19,19,15,9,1,25,0,,
1663,5,187,119,306,86,50,23,19,14,16,10,1,27,0,,
1663,12,168,99,267,45,51,36,14,19,13,13,0,26,0,,
1664,18,188,114,302,85,40,39,20,12,10,15,1,26,0,,
1664,9,181,116,297,75,46,22,12,20,13,6,2,21,0,,
1665,16,215,122,337,97,31,39,13,12,12,13,1,26,0,,
1665,10,188,101,289,76,37,12,12,13,8,12,0,20,0,,
1666,13,200,88,288,81,28,35,24,16,10,12,3,25,0,,
1666,3,198,119,317,96,35,30,16,24,17,10,0,27,0,,
1667,7,191,107,298,101,42,14,17,24,15,8,1,24,0,,
1667,11,165,116,281,58,43,36,24,17,13,11,2,26,0,,
1668,14,185,117,302,95,30,25,13,12,9,15,2,26,0,,
1668,15,212,96,308,96,42,33,12,13,13,13,3,29,0,,
1669,1,179,113,292,85,40,26,15,9,13,10,1,24,0,,
1669,2,215,102,317,110,39,25,9,15,16,12,3,31,0,,
1670,8,196,93,289,87,54,27,15,10,13,12,1,26,0,,
1670,4,147,125,272,48,27,52,10,15,14,4,1,19,0,,
1671,12,194,73,267,54,42,32,21,21,15,14,1,30,0,,
1671,3,204,110,314,79,47,25,21,21,13,14,2,29,0,,
1672,15,182,107,289,82,25,21,19,15,16,12,1,29,0,,
1673,5,187,88,275,79,50,18,23,19,18,7,1,26,0,,
1673,14,149,90,239,55,32,43,19,23,10,9,0,19,0,,
1674,4,219,136,355,79,33,45,27,19,21,18,0,39,0,,
1674,7,178,100,278,86,43,14,19,27,11,6,2,19,0,,
1675,18,199,93,292,62,42,45,19,22,19,13,1,33,0,,
1675,8,185,94,279,68,47,33,22,19,11,4,1,16,0,,
1676,1,166,125,291,86,33,15,19,19,14,10,1,25,0,,
1676,13,201,109,310,110,38,31,19,19,20,5,2,27,0,,
1677,2,217,114,331,68,54,34,20,26,14,8,2,24,0,,
1677,16,195,85,280,62,66,44,26,20,6,10,0,16,0,,
1678,10,168,82,250,79,42,23,23,17,11,7,3,21,0,,
1678,11,161,99,260,58,47,51,17,23,15,12,1,28,0,,
1679,9,183,97,280,90,48,41,14,12,14,10,1,25,0,,
1679,5,198,113,311,88,40,30,12,14,11,13,2,26,0,,
1680,8,190,78,268,84,45,43,13,13,17,7,1,25,0,,
1680,10,161,113,274,68,26,36,13,13,10,5,3,18,0,,
1681,14,186,128,314,83,44,32,16,15,13,11,1,25,0,,
1681,13,175,94,269,81,56,26,15,16,6,8,0,14,0,,
1682,1,194,140,334,91,38,30,15,10,16,13,1,30,0,,
1682,3,201,128,329,100,41,20,10,15,20,9,0,29,0,,
1683,16,199,110,309,79,43,40,15,14,25,16,1,42,0,,
1683,15,198,114,312,94,31,20,14,15,19,7,1,27,0,,
1684,12,173,66,239,70,42,26,21,23,12,11,1,24,0,,
1684,18,226,109,335,124,38,32,23,21,17,11,1,29,0,,
1685,11,188,152,340,64,58,42,15,11,15,13,3,31,0,,
1685,4,171,126,297,63,32,33,11,15,10,11,2,23,0,,
1686,7,175,75,250,82,46,37,19,14,11,12,3,26,0,,
1686,2,184,96,280,84,45,17,14,19,17,4,1,22,0,,
1687,5,186,150,336,66,44,28,14,6,12,8,1,21,0,,
1687,3,209,100,309,100,48,27,6,14,23,6,3,32,0,,
1688,10,174,136,310,69,51,24,15,16,17,6,1,24,0,,
1688,13,170,108,278,83,41,44,17,15,13,4,3,20,0,,
1689,8,179,88,267,87,50,56,15,14,14,10,1,25,0,,
1689,2,182,104,286,83,36,23,14,15,18,5,2,25,0,,
1690,11,173,119,292,68,49,32,16,12,9,8,4,21,0,,
1690,18,191,82,273,90,47,22,12,16,12,4,2,18,0,,
1691,15,196,121,317,78,38,24,17,20,16,15,2,33,0,,
1691,12,178,117,295,68,39,28,20,17,18,11,3,32,0,,
1692,16,179,81,260,84,47,29,19,18,10,11,2,23,0,,
1692,4,189,104,293,71,32,35,18,19,16,9,3,28,0,,
1693,7,195,118,313,102,56,21,17,14,18,10,1,29,0,,
1693,14,165,107,272,67,53,42,14,17,11,6,2,19,0,,
1694,9,210,107,317,107,46,43,14,15,15,13,3,31,0,,
1694,1,219,120,339,112,31,19,15,14,12,4,3,19,0,,
1695,18,226,94,320,106,41,36,12,14,12,11,1,24,0,,
1695,2,179,81,260,97,29,20,14,12,8,8,1,17,0,,
1696,13,163,124,287,48,49,31,15,15,14,9,1,24,0,,
1696,4,186,78,264,68,49,54,15,15,19,10,3,32,0,,
1697,12,179,104,283,49,38,50,15,18,9,9,0,18,0,,
1697,8,181,93,274,56,63,31,18,15,11,7,1,19,0,,
1698,15,188,131,319,81,51,17,14,17,9,15,1,25,0,,
1698,11,204,152,356,93,48,44,17,14,19,8,2,29,0,,
1699,10,171,119,290,82,37,28,19,11,17,5,2,24,0,,
1699,5,176,109,285,83,37,27,11,19,13,10,1,24,0,,
1700,14,181,125,306,77,31,37,12,8,12,5,1,18,0,,
1700,9,184,117,301,78,54,31,8,12,13,13,1,27,0,,
1701,1,204,113,317,96,35,24,21,8,12,9,4,25,0,,
1701,7,191,119,310,107,34,10,8,21,15,10,0,25,0,,
1702,16,222,111,333,102,37,31,22,12,20,9,2,31,0,,
1702,3,173,106,279,66,28,23,12,22,15,10,0,25,0,,
1703,15,180,104,284,79,41,37,12,14,18,8,1,27,0,,
1703,8,191,101,292,77,39,41,14,12,13,8,3,24,0,,
1704,11,180,123,303,51,55,60,11,6,16,13,0,29,0,,
1704,5,163,84,247,54,50,27,6,11,18,5,1,24,0,,
1705,4,192,91,283,77,52,44,15,15,17,9,2,28,0,,
1705,14,166,130,296,66,46,37,15,15,14,11,2,27,0,,
1706,2,199,99,298,96,42,21,21,8,11,16,2,29,0,,
1706,3,163,98,261,84,44,42,8,21,5,8,4,17,0,,
1707,7,214,122,336,106,43,16,14,10,16,16,1,33,0,,
1707,12,170,90,260,50,54,36,10,14,15,6,5,26,0,,
1708,10,167,121,288,85,39,26,13,18,15,6,2,23,0,,
1708,9,145,101,246,53,48,35,18,13,11,8,5,24,0,,
1709,13,181,147,328,88,35,28,10,15,16,12,3,31,0,,
1709,18,208,121,329,113,34,21,15,10,12,9,3,24,0,,
1710,1,198,146,344,100,21,16,15,10,10,9,3,22,0,,
1710,16,225,96,321,122,32,27,10,15,23,14,3,40,0,,
1711,8,179,99,278,84,51,34,12,9,8,4,1,13,0,,
1711,3,215,94,309,80,39,31,9,12,15,15,1,31,0,,
1712,18,219,89,308,98,43,33,16,14,15,11,2,28,0,,
1712,15,187,108,295,67,38,40,14,16,7,4,3,14,0,,
1713,2,199,85,284,98,41,22,17,16,17,9,1,27,0,,
1713,13,173,99,272,62,41,43,16,17,16,6,1,23,0,,
1714,9,176,102,278,92,40,30,11,9,16,9,2,27,0,,
1714,11,190,126,316,79,26,47,9,11,12,14,3,29,0,,
1715,4,182,100,282,80,37,38,13,12,18,9,2,29,0,,
1715,5,180,87,267,67,45,28,12,13,15,12,1,28,0,,
1716,16,221,101,322,112,34,38,10,12,18,14,1,33,0,,
1716,7,210,106,316,116,29,25,12,10,11,14,2,27,0,,
1717,12,173,103,276,62,33,35,14,10,15,13,4,32,0,,
1717,1,167,104,271,61,38,20,10,14,14,15,1,30,0,,
1718,10,179,113,292,89,49,51,12,12,17,7,3,27,0,,
1718,14,145,124,269,67,47,38,12,12,11,4,3,18,0,,
1719,3,176,99,275,70,34,24,16,13,14,12,0,26,0,,
1719,18,208,92,300,96,43,44,13,16,23,7,1,31,0,,
1720,12,176,92,268,62,38,24,17,19,11,8,2,21,0,,
1720,9,245,121,366,123,48,35,19,17,23,12,3,38,0,,
1721,4,211,115,326,89,35,63,10,12,18,15,1,34,0,,
1721,2,184,76,260,92,48,16,12,10,11,5,1,17,0,,
1722,13,183,154,337,70,34,16,17,10,10,11,0,21,0,,
1722,16,194,109,303,101,51,36,10,17,16,5,0,21,0,,
1723,7,169,81,250,76,39,21,13,16,12,9,3,24,0,,
1723,5,202,111,313,108,41,30,16,13,22,13,4,39,0,,
1724,11,204,136,340,97,36,51,9,10,16,11,2,29,0,,
1724,1,172,142,314,75,44,14,10,9,14,7,2,23,0,,
1725,15,176,85,261,66,53,42,14,9,12,11,1,24,0,,
1725,10,153,108,261,66,48,34,9,14,8,11,0,19,0,,
1726,14,179,98,277,68,32,40,17,14,16,11,2,29,0,,
1726,8,156,105,261,77,48,37,14,17,11,8,1,20,0,,
1727,18,208,94,302,104,34,41,15,16,14,10,4,28,0,,
1727,5,154,103,257,64,36,18,16,15,10,9,4,23,0,,
1728,2,157,101,258,70,52,32,10,12,10,10,2,22,0,,
1728,10,179,101,280,89,55,22,12,10,16,8,0,24,0,,
1729,1,175,128,303,76,28,29,17,9,22,9,4,35,0,,
1729,15,200,106,306,95,52,36,9,17,24,10,2,36,0,,
1730,9,207,133,340,93,41,37,8,9,18,12,3,33,0,,
1730,13,182,186,368,84,28,27,9,8,9,7,2,18,0,,
1731,16,208,89,297,85,50,37,22,12,19,11,2,32,0,,
1731,12,179,123,302,58,27,22,12,22,15,9,0,24,0,,
1732,8,170,99,269,62,56,47,16,11,14,3,3,20,0,,
1732,7,200,114,314,74,50,38,11,16,17,12,4,33,0,,
1733,3,217,82,299,93,69,19,14,12,19,11,3,33,0,,
1733,4,168,120,288,62,39,40,12,14,16,8,2,26,0,,
1734,14,154,93,247,65,54,25,23,12,8,8,3,19,0,,
1734,11,176,111,287,75,53,50,12,23,11,10,0,21,0,,
1735,15,185,104,289,90,48,31,9,14,13,12,2,27,0,,
1735,2,178,96,274,87,52,43,14,9,13,7,4,24,0,,
1736,7,216,124,340,102,39,28,18,14,13,11,1,25,0,,
1736,9,190,103,293,90,53,31,14,18,13,7,0,20,0,,
1737,10,166,80,246,72,60,50,15,9,21,6,1,28,0,,
1737,3,163,81,244,44,51,41,9,15,12,2,5,19,0,,
1738,8,166,121,287,58,63,50,19,11,11,8,1,20,0,,
1738,11,159,105,264,51,45,46,11,19,10,8,2,20,0,,
1739,18,214,119,333,115,43,31,11,12,16,14,2,32,0,,
1739,16,185,83,268,96,43,21,12,11,9,6,3,18,0,,
1740,4,186,116,302,83,38,34,4,15,19,8,2,29,0,,
1741,14,195,104,299,99,45,29,19,17,17,11,2,30,0,,
1741,12,167,103,270,65,59,34,17,19,12,3,0,15,0,,
1742,13,172,102,274,81,40,36,10,12,10,11,6,27,0,,
1742,5,221,107,328,120,34,20,12,10,20,12,1,33,0,,
1743,3,188,89,277,92,31,36,12,10,13,6,4,23,0,,
1743,15,202,101,303,94,54,29,10,12,14,12,0,26,0,,
1744,16,203,110,313,101,56,31,17,16,13,8,2,23,0,,
1744,14,172,104,276,70,48,29,16,17,10,8,4,22,0,,
1745,10,182,126,308,84,41,36,13,21,19,11,2,32,0,,
1745,1,160,82,242,64,38,27,21,13,9,8,1,18,0,,
1746,2,182,88,270,98,37,24,9,8,12,11,3,26,0,,
1746,12,196,99,295,84,36,35,8,9,14,8,1,23,0,,
1747,18,215,143,358,119,35,43,5,7,15,8,1,24,0,,
1747,7,192,119,311,95,45,17,7,5,7,12,3,22,0,,
1748,5,183,98,281,69,39,33,22,19,6,10,5,21,0,,
1748,8,183,98,281,91,40,26,19,22,12,10,2,24,0,,
1749,11,203,143,346,91,52,33,26,7,21,11,1,33,0,,
1749,13,164,115,279,86,46,28,7,26,10,4,1,15,0,,
1750,9,169,120,289,61,45,42,9,7,13,12,1,26,0,,
1750,4,187,144,331,74,47,31,7,9,24,14,2,40,0,,
1751,3,199,118,317,98,55,27,10,12,20,8,1,29,0,,
1751,14,187,120,307,87,33,47,12,10,15,3,0,18,0,,
1752,18,195,94,289,72,38,50,20,13,14,10,5,29,0,,
1752,10,163,92,255,72,47,29,13,20,8,12,0,20,0,,
1753,13,193,118,311,87,41,34,21,16,21,10,0,31,0,,
1753,7,175,105,280,87,35,28,16,21,14,5,5,24,0,,
1754,9,203,114,317,72,58,28,16,12,15,13,1,29,0,,
1754,2,184,110,294,98,35,36,12,16,9,7,0,16,0,,
1755,1,171,123,294,84,40,23,16,15,12,6,7,25,0,,
1755,5,212,130,342,117,32,22,15,16,18,17,3,38,0,,
1756,4,177,86,263,39,58,50,18,16,11,6,4,21,0,,
1756,15,221,77,298,67,54,40,16,18,10,6,1,17,0,,
1757,12,158,68,226,32,67,26,11,7,7,5,3,15,0,,
1757,11,210,95,305,72,67,60,7,11,13,12,2,27,0,,
1758,8,203,126,329,76,44,31,16,15,15,7,1,23,0,,
1758,16,195,105,300,71,32,46,15,16,10,8,0,18,0,,
1759,7,167,103,270,82,49,40,13,15,7,5,4,16,0,,
1759,3,205,111,316,85,49,33,15,13,17,15,2,34,0,,
1760,16,216,110,326,106,53,39,21,17,10,14,1,25,0,,
1760,9,183,109,292,86,58,21,17,21,10,8,4,22,0,,
1761,11,192,118,310,99,33,33,13,14,10,10,2,22,0,,
1761,2,189,101,290,109,43,29,14,13,6,6,2,14,0,,
1762,8,184,114,298,83,34,31,25,18,23,15,1,39,0,,
1762,1,163,110,273,70,38,30,18,25,12,7,4,23,0,,
1763,15,181,92,273,99,33,31,18,15,7,7,1,15,0,,
1763,5,209,112,321,108,28,20,15,18,19,11,1,31,0,,
1764,10,194,118,312,92,46,41,11,6,13,10,4,27,0,,
1764,4,173,88,261,61,31,36,6,11,12,8,4,24,0,,
1765,14,171,120,291,91,39,28,21,17,10,8,2,20,0,,
1765,18,178,100,278,69,56,31,17,21,10,8,1,19,0,,
1766,12,179,72,251,70,41,30,18,15,14,6,0,20,0,,
1766,13,199,125,324,96,46,37,15,18,14,10,3,27,0,,
1767,11,203,103,306,54,68,43,31,18,13,8,4,25,0,,
1767,3,169,71,240,42,75,33,18,31,7,4,3,14,0,,
1768,5,222,118,340,89,43,22,12,13,15,8,1,24,0,,
1768,16,184,100,284,80,51,30,13,12,7,13,3,23,0,,
1769,10,204,102,306,101,40,49,22,13,15,17,5,37,0,,
1769,7,168,113,281,86,43,23,13,22,9,6,1,16,0,,
1770,4,233,138,371,100,44,27,22,13,28,16,3,47,0,,
1770,12,175,93,268,75,29,32,13,22,10,10,1,21,0,,
1771,14,181,124,305,92,56,33,10,20,15,9,2,26,0,,
1771,2,177,131,308,72,37,41,20,10,15,5,2,22,0,,
1772,13,212,130,342,108,37,25,13,17,14,8,2,24,0,,
1772,15,208,135,343,84,36,29,17,13,15,8,3,26,0,,
1773,1,176,139,315,97,22,15,22,15,14,6,3,23,0,,
1773,18,235,77,312,139,24,30,15,22,15,17,1,33,0,,
1774,9,187,104,291,101,29,31,18,13,14,7,2,23,0,,
1774,8,176,113,289,74,36,31,13,18,11,14,1,26,0,,
1775,2,183,118,301,103,38,49,16,22,9,7,1,17,0,,
1775,5,205,114,319,95,54,15,22,16,20,9,2,31,0,,
1776,18,202,84,286,103,42,36,22,21,17,10,2,29,0,,
1776,4,139,101,240,62,35,38,21,22,7,7,1,15,0,,
1777,8,196,97,293,97,44,29,19,29,17,9,2,28,0,,
1777,13,171,124,295,62,25,30,29,19,15,11,5,31,0,,
1778,3,196,124,320,83,43,28,17,19,14,8,2,24,0,,
1778,9,180,96,276,83,52,34,19,17,12,10,4,26,0,,
1779,12,155,71,226,48,50,35,22,20,12,11,1,24,0,,
1779,10,186,116,302,85,50,38,20,22,18,7,0,25,0,,
1780,7,183,130,313,96,30,28,10,10,21,6,0,27,0,,
1780,15,186,96,282,81,60,43,10,10,19,11,2,32,0,,
1781,14,193,123,316,104,35,23,18,17,11,13,2,26,0,,
1781,1,204,118,322,111,35,30,17,18,15,7,2,24,0,,
1782,16,187,106,293,91,51,31,19,16,13,12,1,26,0,,
1782,11,159,99,258,58,35,35,16,19,13,12,0,25,0,,
1783,4,192,103,295,72,40,38,23,12,14,10,4,28,0,,
1783,8,168,101,269,87,52,31,12,23,5,11,1,17,0,,
1784,1,175,131,306,77,47,27,17,18,14,7,4,25,0,,
1784,2,192,120,312,101,44,46,18,17,24,10,1,35,0,,
1785,9,181,75,256,88,35,38,23,11,15,12,1,28,0,,
1785,18,177,86,263,81,34,34,11,23,15,11,3,29,0,,
1786,13,181,106,287,64,49,39,22,14,10,10,1,21,0,,
1786,3,201,122,323,83,45,29,14,22,13,7,3,23,0,,
1787,15,193,111,304,87,44,34,13,12,16,6,2,24,0,,
1787,14,168,148,316,77,24,23,12,13,12,11,3,26,0,,
1788,11,189,121,310,79,46,62,18,15,22,9,2,33,0,,
1788,7,156,119,275,71,49,27,15,18,13,8,0,21,0,,
1789,10,171,90,261,78,22,30,10,13,17,8,1,26,0,,
1789,16,163,73,236,74,47,22,13,10,14,12,1,27,0,,
1790,5,204,108,312,95,46,20,18,19,20,13,2,35,0,,
1790,12,167,66,233,76,43,31,19,18,8,13,1,22,0,,
1791,1,216,166,382,122,34,22,9,11,14,16,1,31,0,,
1791,13,185,124,309,116,37,36,11,9,12,4,4,20,0,,
1792,16,191,106,297,96,66,31,17,15,15,14,0,29,0,,
1792,2,172,123,295,71,38,24,15,17,11,11,4,26,0,,
1793,9,203,147,350,104,34,34,8,13,20,15,2,37,0,,
1793,15,199,124,323,100,29,24,13,8,11,14,3,28,0,,
1794,5,173,101,274,79,51,34,12,18,14,11,2,27,0,,
1794,14,172,106,278,93,40,37,18,12,10,10,3,23,0,,
1795,3,197,103,300,92,47,26,16,13,13,10,2,25,0,,
1795,12,182,88,270,69,42,36,13,16,7,10,4,21,0,,
1796,7,187,118,305,71,54,39,11,18,19,13,1,33,0,,
1796,4,161,93,254,67,56,44,18,11,9,9,4,22,0,,
1797,8,180,84,264,82,47,14,18,9,11,11,3,25,0,,
1797,18,167,94,261,59,36,47,9,18,12,9,3,24,0,,
1798,11,171,98,269,63,49,59,20,19,14,13,0,27,0,,
1798,10,162,95,257,76,42,29,19,20,14,6,3,23,0,,
1799,13,154,95,249,42,76,65,21,17,6,7,2,15,0,,
1799,14,192,94,286,79,63,25,17,21,11,15,3,29,0,,
1800,5,168,100,268,66,40,27,16,9,8,11,3,22,0,,
1800,9,199,102,301,103,41,38,9,16,15,8,3,26,0,,
1801,7,197,107,304,102,39,20,13,15,20,9,1,30,0,,
1801,2,191,120,311,102,33,40,15,13,7,6,2,15,0,,
1802,10,168,100,268,75,36,30,14,15,14,7,2,23,0,,
1802,8,166,96,262,66,45,44,15,14,17,8,0,25,0,,
1803,4,156,113,269,62,50,34,17,10,10,6,1,17,0,,
1803,11,182,96,278,78,50,48,10,17,13,11,2,26,0,,
1804,3,219,120,339,116,41,35,9,21,22,13,2,37,0,,
1804,1,172,114,286,82,38,24,21,9,12,7,1,20,0,,
1805,18,222,101,323,101,50,23,25,18,18,13,4,35,0,,
1805,12,169,67,236,59,29,16,18,25,12,8,1,21,0,,
1806,16,173,117,290,82,38,45,14,16,15,9,0,24,0,,
1806,15,201,97,298,93,39,27,16,14,15,7,1,23,0,,
1807,5,195,134,329,84,52,33,13,10,15,18,0,33,0,,
1807,11,169,91,260,82,43,37,10,13,11,3,2,16,0,,
1808,14,177,101,278,85,46,22,18,13,9,7,2,18,0,,
1809,12,165,102,267,54,52,27,16,17,11,8,1,20,0,,
1809,7,221,156,377,115,46,35,17,16,26,8,2,36,0,,
1810,18,219,91,310,120,39,34,12,17,17,8,2,27,0,,
1810,13,183,134,317,94,40,27,17,12,15,4,4,23,0,,
1811,15,194,83,277,90,29,32,11,14,14,9,3,26,0,,
1811,8,199,132,331,99,30,28,14,11,16,11,3,30,0,,
1812,9,162,108,270,69,50,51,10,8,10,14,2,26,0,,
1812,10,170,111,281,98,43,27,8,10,14,6,0,20,0,,
1813,16,210,122,332,102,36,44,9,17,18,23,2,43,0,,
1813,1,164,127,291,76,20,8,17,9,12,5,0,17,0,,
1814,2,192,130,322,95,44,31,12,10,7,9,2,18,0,,
1814,3,195,124,319,101,51,23,10,12,13,12,2,27,0,,
1815,8,206,128,334,102,46,30,18,12,20,14,4,38,0,,
1815,12,150,101,251,53,26,22,12,18,10,3,1,14,0,,
1816,3,206,110,316,89,37,18,9,15,20,12,1,33,0,,
1816,16,199,94,293,121,38,38,15,8,11,5,2,18,0,,
1817,11,174,90,264,63,51,38,22,12,10,4,0,14,0,,
1817,15,201,89,290,60,57,44,12,22,9,18,2,29,0,,
1818,9,201,139,340,93,40,41,15,9,19,6,3,28,0,,
1818,14,173,107,280,70,41,37,9,15,13,8,0,21,0,,
1819,10,203,119,322,65,62,46,25,15,12,5,4,21,0,,
1819,5,195,87,282,54,66,46,15,25,14,10,5,29,0,,
1820,4,199,117,316,88,43,41,17,7,21,14,3,38,0,,
1820,13,164,131,295,71,49,33,7,17,14,7,0,21,0,,
1821,18,198,89,287,104,34,32,19,18,18,16,0,34,0,,
1821,2,165,133,298,86,27,29,18,19,16,6,2,24,0,,
1822,7,211,135,346,85,51,51,19,14,13,14,3,30,0,,
1822,1,165,130,295,57,49,31,14,19,3,11,1,15,0,,
1823,5,188,102,290,76,57,35,16,11,12,11,0,23,0,,
1823,3,176,108,284,53,57,30,11,16,9,11,2,22,0,,
1824,13,126,98,224,44,61,57,13,15,9,4,2,15,0,,
1824,10,150,129,279,62,50,31,15,13,14,8,2,24,0,,
1825,14,184,88,272,84,61,51,18,12,12,7,5,24,0,,
1825,7,189,112,301,73,69,36,12,18,9,8,3,20,0,,
1826,1,185,130,315,103,38,21,12,9,13,8,0,21,0,,
1826,9,227,141,368,102,40,44,9,12,26,11,3,40,0,,
1827,4,178,109,287,62,39,26,23,17,11,15,1,27,0,,
1827,16,173,97,270,81,53,41,17,23,14,10,2,26,0,,
1828,2,172,99,271,71,35,44,16,22,11,7,1,19,0,,
1828,8,198,96,294,108,44,22,22,16,11,9,3,23,0,,
1829,15,242,109,351,125,36,30,20,15,28,17,2,47,0,,
1829,12,168,113,281,80,35,27,15,20,9,6,3,18,0,,
1830,18,194,96,290,98,44,27,19,14,14,9,1,24,0,,
1830,11,149,127,276,51,30,29,14,19,12,5,1,18,0,,
1831,3,212,107,319,92,28,14,17,13,15,11,0,26,0,,
1831,16,200,103,303,101,55,56,13,17,8,8,1,17,0,,
1832,11,207,131,338,76,30,40,15,13,16,15,2,33,0,,
1832,4,156,121,277,56,40,26,13,15,8,7,2,17,0,,
1833,5,200,108,308,100,37,26,12,13,9,11,1,21,0,,
1833,9,194,105,299,98,43,37,13,12,7,6,3,16,0,,
1834,10,155,115,270,62,58,28,12,19,15,8,2,25,0,,
1834,18,151,101,252,55,50,54,19,12,13,9,1,23,0,,
1835,9,180,127,307,62,46,33,14,12,18,13,3,34,0,,
1835,11,176,118,294,67,43,48,12,14,12,10,0,22,0,,
1836,18,218,83,301,81,51,50,26,13,12,10,1,23,0,,
1836,3,168,116,284,72,46,16,13,26,6,5,3,14,0,,
1837,9,194,98,292,92,48,43,12,17,14,12,4,30,0,,
1837,10,163,82,245,87,31,32,17,12,8,6,2,16,0,,
1838,5,189,98,287,91,46,26,21,16,17,7,3,27,0,,
1838,18,172,97,269,76,40,32,16,21,9,11,3,23,0,,
1839,9,191,120,311,85,47,55,13,18,20,12,2,34,0,,
1839,5,155,94,249,52,48,31,18,13,12,8,4,24,0,,
1840,2,211,111,322,113,48,39,12,21,14,11,2,27,0,,
1840,5,178,75,253,86,34,22,21,12,8,9,0,17,0,,
1841,8,194,127,321,81,36,45,15,15,17,13,4,34,0,,
1841,13,176,90,266,73,38,31,15,15,10,9,1,20,0,,
1842,16,210,125,335,98,42,42,16,16,15,15,2,32,0,,
1842,12,180,92,272,63,36,16,16,16,8,9,3,20,0,,
1843,9,164,97,261,75,30,29,12,19,11,10,4,25,0,,
1843,10,191,125,316,106,29,19,19,12,11,10,2,23,0,,
1844,7,203,108,311,108,61,42,14,20,19,8,0,27,0,,
1844,14,170,83,253,85,42,22,20,14,9,7,0,16,0,,
1845,18,214,152,366,105,34,33,14,11,23,16,4,43,0,,
1845,3,171,105,276,71,31,31,11,14,8,10,4,22,0,,
1846,15,209,104,313,79,45,32,10,8,23,9,2,34,0,,
1846,11,161,91,252,65,34,43,8,10,10,11,3,24,0,,
1847,1,198,91,289,100,34,30,18,10,20,15,2,37,0,,
1847,4,176,102,278,66,39,37,10,18,22,10,2,34,0,,
1848,13,208,109,317,85,44,27,19,15,20,11,3,34,0,,
1848,2,204,110,314,106,40,37,15,19,12,4,0,16,0,,
1849,5,176,87,263,82,29,31,13,19,15,12,4,31,0,,
1849,1,199,107,306,101,52,33,19,13,13,16,3,32,0,,
1850,11,179,77,256,84,45,45,11,14,11,13,4,28,0,,
1850,9,181,106,287,76,51,36,14,11,15,12,2,29,0,,
1851,4,163,115,278,60,42,31,15,12,17,13,0,30,0,,
1851,18,184,94,278,101,41,28,12,15,18,10,0,28,0,,
1852,3,213,118,331,116,26,29,20,27,8,9,3,20,0,,
1852,7,217,119,336,107,30,19,27,20,13,14,2,29,0,,
1853,10,202,140,342,98,55,31,18,12,15,10,2,27,0,,
1853,16,174,81,255,58,60,52,12,18,10,10,1,21,0,,
1854,12,193,121,314,93,39,35,26,15,16,7,1,24,0,,
1854,14,189,90,279,84,42,24,15,26,6,13,1,20,0,,
1855,8,191,107,298,96,30,33,21,15,11,6,2,19,0,,
1855,15,203,110,313,82,29,21,15,21,15,12,1,28,0,,
1856,9,181,99,280,86,48,34,13,21,21,6,5,32,0,,
1856,5,186,73,259,83,35,23,21,13,12,4,1,17,0,,
1857,15,171,86,257,73,39,41,17,19,17,7,2,26,0,,
1857,12,180,112,292,82,42,24,19,17,16,9,1,26,0,,
1858,3,217,104,321,106,42,39,15,21,22,5,0,27,0,,
1858,4,174,109,283,59,45,41,21,15,20,7,4,31,0,,
1859,10,154,109,263,61,44,44,21,17,10,10,3,23,0,,
1859,14,186,61,247,95,49,18,18,21,10,5,2,17,0,,
1860,18,217,119,336,106,37,30,25,16,26,11,4,41,0,,
1860,8,167,82,249,69,41,30,16,25,13,10,2,25,0,,
1861,1,197,104,301,100,34,25,11,16,12,14,1,27,0,,
1861,13,203,86,289,100,29,31,16,11,12,19,5,36,0,,
1862,16,216,126,342,121,41,26,18,9,10,11,2,23,0,,
1862,11,200,112,312,94,32,21,9,18,8,15,1,24,0,,
1863,7,162,119,281,85,43,31,7,13,16,12,6,34,0,,
1863,2,166,90,256,99,39,46,13,7,10,8,0,18,0,,
1864,12,177,83,260,81,39,37,18,20,12,8,0,20,0,,
1864,3,181,107,288,76,42,30,20,18,17,14,1,32,0,,
1865,13,203,111,314,108,36,28,11,13,18,11,5,34,0,,
1865,18,165,132,297,78,44,42,13,11,10,10,1,21,0,,
1866,4,171,92,263,76,45,43,18,11,12,7,0,19,0,,
1866,9,173,123,296,51,65,39,11,18,10,15,1,26,0,,
1867,11,186,126,312,76,45,45,15,11,15,5,3,23,0,,
1867,7,195,123,318,111,35,23,11,15,18,4,1,23,0,,
1868,14,189,113,302,102,44,23,14,28,19,7,6,32,0,,
1868,2,183,131,314,70,44,50,28,14,11,9,0,20,0,,
1869,15,180,84,264,82,49,32,8,14,10,9,1,20,0,,
1869,10,199,190,389,94,34,30,14,8,18,12,1,31,0,,
1870,5,193,83,276,96,36,26,16,9,7,7,4,18,0,,
1870,16,209,114,323,100,45,26,9,16,12,16,0,28,0,,
1871,8,201,123,324,96,47,34,14,15,14,11,2,27,0,,
1871,1,196,123,319,82,43,24,15,14,16,10,3,29,0,,
1872,2,165,121,286,74,42,37,18,20,9,3,1,13,0,,
1872,11,191,110,301,86,48,29,20,18,21,8,0,29,0,,
1873,12,225,89,314,88,65,30,19,12,14,6,2,22,0,,
1873,4,182,120,302,59,43,37,12,19,6,6,1,13,0,,
1874,7,190,132,322,102,45,35,23,13,20,9,1,30,0,,
1874,15,160,109,269,64,35,27,13,23,8,16,1,25,0,,
1875,9,202,101,303,88,41,31,14,13,14,20,6,40,0,,
1875,8,237,84,321,138,33,20,14,14,9,5,3,17,0,,
1876,10,162,106,268,75,44,39,20,13,15,8,1,24,0,,
1876,13,155,83,238,67,60,40,14,20,17,9,0,26,0,,
1877,5,200,96,296,82,30,26,16,18,11,11,2,24,0,,
1877,3,203,107,310,104,39,37,18,16,17,7,3,27,0,,
1878,18,187,122,309,106,30,26,10,12,17,14,3,34,0,,
1878,1,200,106,306,102,29,27,12,10,7,20,0,27,0,,
1879,16,196,130,326,79,43,40,15,10,18,8,1,27,0,,
1879,14,202,112,314,103,39,14,10,15,14,7,0,21,0,,
1880,2,194,107,301,82,38,34,20,20,12,9,2,23,0,,
1880,8,196,81,277,107,41,36,20,20,13,5,0,18,0,,
1881,15,179,105,284,63,57,33,21,14,18,10,1,29,0,,
1881,1,155,95,250,61,47,49,14,21,19,6,0,25,0,,
1882,3,194,74,268,70,57,49,21,18,16,10,2,28,0,,
1882,10,176,80,256,84,47,34,18,21,15,5,3,23,0,,
1883,7,186,104,290,89,53,30,17,17,13,13,1,27,0,,
1883,9,185,116,301,84,57,35,17,17,14,6,1,21,0,,
1884,4,161,131,292,57,53,25,13,9,11,6,1,18,0,,
1884,16,180,101,281,87,56,46,9,13,12,9,2,23,0,,
1885,14,163,91,254,69,48,26,22,18,15,10,1,26,0,,
1885,11,172,83,255,63,55,53,18,22,8,9,1,18,0,,
1886,13,231,140,371,90,38,26,21,14,25,9,1,35,0,,
1886,12,189,106,295,71,41,33,14,21,8,5,2,15,0,,
1887,18,208,126,334,107,35,43,13,11,14,16,1,31,0,,
1887,5,215,116,331,88,30,17,11,13,12,11,0,23,0,,
1888,1,189,97,286,92,35,34,18,7,14,9,1,24,0,,
1888,3,195,118,313,101,39,22,7,18,18,11,2,31,0,,
1889,12,156,79,235,67,55,33,19,13,13,10,1,24,0,,
1889,5,166,85,251,62,48,37,13,19,11,13,1,25,0,,
1890,16,194,113,307,91,55,56,13,10,11,6,0,17,0,,
1890,7,195,89,284,88,45,20,10,13,14,10,1,25,0,,
1891,18,161,111,272,73,44,27,11,17,13,7,2,22,0,,
1891,11,179,104,283,80,43,45,17,11,17,14,3,34,0,,
1892,15,202,112,314,114,23,18,18,19,11,10,0,21,0,,
1892,9,214,118,332,100,34,33,19,18,18,8,4,30,0,,
1893,10,168,86,254,70,52,30,17,18,8,6,0,14,0,,
1893,2,170,100,270,70,59,52,18,17,10,7,0,17,0,,
1894,13,210,114,324,107,52,32,12,14,18,9,5,32,0,,
1894,4,175,116,291,82,33,29,14,12,11,7,0,18,0,,
1895,8,151,75,226,65,55,57,12,16,8,3,1,12,0,,
1895,14,179,100,279,91,57,21,16,12,15,14,4,33,0,,
1896,11,157,83,240,61,41,44,17,14,12,9,3,24,0,,
1896,3,181,69,250,82,51,30,14,17,20,11,4,35,0,,
1897,2,191,114,305,90,44,47,12,7,15,13,0,28,0,,
1897,1,188,125,313,90,45,24,7,12,10,19,1,30,0,,
1898,4,175,111,286,70,42,42,12,13,18,14,2,34,0,,
1898,10,156,114,270,58,35,35,13,12,15,7,0,22,0,,
1899,9,177,132,309,75,46,50,9,11,21,13,1,35,0,,
1899,12,179,94,273,77,33,26,11,9,16,5,1,22,0,,
1900,7,160,114,274,76,36,34,16,11,21,9,3,33,0,,
1900,5,164,94,258,76,54,39,11,16,13,11,2,26,0,,
1901,8,189,97,286,86,42,35,16,11,10,8,2,20,0,,
1901,16,183,101,284,101,39,22,11,16,8,9,4,21,0,,
1902,14,220,105,325,118,26,27,13,20,15,9,2,26,0,,
1902,13,187,93,280,80,52,39,20,13,12,14,0,26,0,,
1903,15,204,123,327,95,42,22,12,13,21,12,2,35,0,,
1903,18,144,139,283,60,42,37,13,12,7,5,1,13,0,,
1904,5,191,90,281,94,45,21,10,20,9,13,1,23,0,,
1904,11,188,113,301,91,33,38,20,10,9,9,2,20,0,,
1905,13,187,146,333,96,35,31,8,11,13,16,2,31,0,,
1905,15,199,101,300,83,36,35,11,8,11,8,4,23,0,,
1906,16,211,148,359,94,52,47,16,9,20,13,4,37,0,,
1906,9,162,127,289,65,36,22,9,16,11,10,2,23,0,,
1907,18,216,160,376,105,47,41,11,20,19,12,2,33,0,,
1907,2,174,129,303,79,41,21,20,11,7,6,1,14,0,,
1908,14,200,82,282,107,45,26,20,25,18,9,3,30,0,,
1908,3,182,103,285,72,31,31,25,20,14,12,1,27,0,,
1909,10,164,109,273,80,52,35,9,10,11,12,2,25,0,,
1909,8,157,82,239,54,56,49,10,9,12,6,1,19,0,,
1910,12,180,84,264,76,32,37,18,21,12,6,1,19,0,,
1910,1,188,99,287,75,40,32,21,18,16,7,1,24,0,,
1911,7,182,115,297,82,53,45,8,17,26,10,3,39,0,,
1911,4,149,102,251,51,47,40,17,8,9,8,6,23,0,,
1912,3,196,121,317,107,31,26,18,13,17,10,3,30,0,,
1912,16,179,108,287,92,42,23,13,18,12,8,5,25,0,,
1913,8,147,98,245,69,43,51,12,14,6,7,4,17,0,,
1913,11,197,101,298,109,55,35,14,12,20,9,4,33,0,,
1914,4,191,149,340,84,58,34,5,19,14,16,0,30,0,,
1914,2,163,133,296,78,41,37,19,5,9,8,1,18,0,,
1915,15,176,103,279,87,32,25,10,19,9,10,1,20,0,,
1915,5,205,85,290,111,30,28,19,10,13,11,3,27,0,,
1916,1,165,87,252,73,40,37,15,14,10,6,1,17,0,,
1916,10,194,140,334,97,34,38,14,15,12,13,8,33,0,,
1917,18,179,132,311,75,39,47,18,16,18,6,2,26,0,,
1917,14,178,95,273,89,42,24,16,18,17,10,0,27,0,,
1918,12,164,91,255,59,44,35,21,18,13,8,2,23,0,,
1918,7,222,144,366,100,56,47,18,21,31,9,1,41,0,,
1919,13,177,104,281,81,43,41,13,10,12,8,3,23,0,,
1919,9,196,110,306,88,62,29,10,13,18,12,3,33,0,,
1920,5,215,68,283,131,37,28,17,14,14,8,1,23,0,,
1920,4,164,125,289,66,35,39,14,17,11,8,1,20,0,,
1921,11,172,112,284,76,37,43,14,13,12,12,3,27,0,,
1921,12,161,74,235,55,48,30,13,14,14,6,1,21,0,,
1922,8,161,92,253,71,55,53,21,18,12,5,3,20,0,,
1922,3,202,80,282,102,38,23,18,21,24,8,2,34,0,,
1923,9,201,129,330,87,47,27,7,7,18,13,1,32,0,,
1923,18,201,102,303,105,40,32,7,7,12,10,4,26,0,,
1924,15,200,104,304,94,29,37,8,14,24,9,1,34,0,,
1924,2,154,106,260,62,39,31,14,8,12,7,1,20,0,,
1925,10,171,125,296,83,62,34,19,13,17,8,2,27,0,,
1925,7,130,84,214,45,54,46,13,19,11,9,1,21,0,,
1926,1,165,99,264,77,35,35,14,19,10,6,0,16,0,,
1926,14,200,128,328,111,57,24,19,14,17,9,2,28,0,,
1927,16,182,102,284,69,54,43,11,21,9,7,1,17,0,,
1927,13,185,97,282,56,67,36,21,11,13,11,4,28,0,,
1928,12,163,80,243,56,57,32,17,13,15,3,7,25,0,,
1928,8,158,106,264,62,57,50,13,17,14,3,1,18,0,,
1929,1,198,135,333,91,52,33,9,6,15,8,4,27,0,,
1929,7,164,128,292,73,42,28,6,9,11,9,5,25,0,,
1930,3,184,115,299,79,37,23,17,18,14,11,1,26,0,,
1930,9,201,121,322,94,36,43,18,17,25,9,3,37,0,,
1931,4,186,102,288,78,35,33,20,19,15,13,5,33,0,,
1931,11,160,131,291,63,45,30,19,20,11,9,1,21,0,,
1932,18,202,126,328,92,45,53,18,22,20,10,2,32,0,,
1932,10,146,134,280,63,52,23,22,18,8,12,0,20,0,,
1933,14,168,114,282,90,39,25,13,21,14,10,0,24,0,,
1933,15,156,76,232,49,46,40,21,13,12,11,1,24,0,,
1934,2,172,122,294,63,51,35,14,10,10,10,0,20,0,,
1934,16,192,102,294,84,42,29,10,14,12,8,1,21,0,,
1935,13,187,86,273,60,56,39,12,16,12,8,2,22,0,,
1935,5,185,66,251,81,46,35,16,12,11,7,0,18,0,,
1936,7,199,119,318,104,51,33,13,12,19,11,2,32,0,,
1936,8,161,95,256,71,43,44,12,13,9,6,1,16,0,,
1937,14,203,114,317,91,71,28,18,19,13,10,4,27,0,,
1937,9,156,99,255,43,85,53,19,18,9,11,0,20,0,,
1938,2,172,92,264,79,34,33,35,20,14,8,0,22,0,,
1938,12,185,63,248,79,30,22,20,35,18,14,2,34,0,,
1939,16,172,108,280,79,44,33,15,15,16,5,1,22,0,,
1939,18,199,111,310,107,30,36,15,15,17,6,4,27,0,,
1940,15,198,75,273,81,51,28,11,16,16,9,3,28,0,,
1940,4,154,97,251,53,32,45,16,11,11,9,0,20,0,,
1941,11,188,98,286,94,32,33,11,18,20,12,1,33,0,,
1941,1,195,100,295,113,38,25,18,11,15,10,1,26,0,,
1942,3,177,107,284,77,54,38,7,9,10,7,2,19,0,,
1942,13,209,116,325,90,50,22,9,7,13,17,0,30,0,,
1943,10,147,111,258,64,45,36,12,17,13,7,0,20,0,,
1943,5,158,77,235,69,55,38,17,12,11,10,3,24,0,,
1944,3,177,106,283,99,34,31,12,23,12,6,1,19,0,,
1944,15,202,80,282,93,49,30,23,12,14,14,2,30,0,,
1945,12,144,79,223,46,64,41,22,19,12,12,0,24,0,,
1945,10,146,111,257,65,45,44,19,22,15,5,0,20,0,,
1946,5,213,115,328,100,51,40,9,13,20,16,4,40,0,,
1946,8,179,114,293,73,30,32,13,9,11,8,1,20,0,,
1947,9,200,114,314,104,34,30,8,8,17,11,1,29,0,,
1947,2,183,130,313,86,30,25,8,8,14,11,1,26,0,,
1948,4,182,120,302,76,68,43,14,9,7,7,2,16,0,,
1948,14,166,91,257,68,55,22,9,14,7,5,2,14,0,,
1949,7,163,91,254,81,47,15,27,16,7,4,1,12,0,,
1949,18,208,130,338,98,45,39,16,27,14,8,1,23,0,,
1950,1,189,108,297,66,31,21,21,12,10,10,5,25,0,,
1950,16,195,119,314,96,44,38,12,21,18,8,1,27,0,,
1951,11,193,146,339,87,53,51,16,7,22,10,3,35,0,,
1951,13,143,123,266,56,53,30,7,16,10,12,1,23,0,,
1952,5,191,115,306,92,46,23,16,19,9,10,1,20,0,,
1952,14,195,114,309,88,55,46,19,16,12,19,3,34,0,,
1953,8,176,100,276,79,44,28,19,15,12,9,1,22,0,,
1953,4,197,118,315,103,50,37,15,19,12,10,4,26,0,,
1954,2,183,136,319,76,37,32,17,21,11,7,2,20,0,,
1954,3,209,129,338,94,43,26,21,17,24,9,2,35,0,,
1955,10,159,73,232,65,70,46,14,15,8,9,1,18,0,,
1955,11,152,78,230,50,68,55,15,14,6,6,3,15,0,,
1956,16,170,149,319,64,29,36,16,14,12,6,1,19,0,,
1956,15,192,120,312,80,52,25,14,15,14,9,3,26,0,,
1957,9,195,126,321,103,46,38,9,5,20,15,1,36,0,,
1957,1,161,118,279,84,45,25,5,9,10,6,2,18,0,,
1958,13,173,118,291,70,67,32,9,20,23,8,0,31,0,,
1958,7,146,118,264,58,60,43,20,9,13,8,3,24,0,,
1959,18,195,137,332,92,46,36,16,11,18,12,3,33,0,,
1959,12,161,78,239,81,34,28,11,16,5,10,0,15,0,,
1960,4,215,130,345,102,40,40,10,14,18,7,2,27,0,,
1960,3,181,135,316,72,37,21,14,10,10,11,2,23,0,,
1961,12,176,94,270,84,46,27,15,13,9,14,2,25,0,,
1961,15,170,95,265,72,54,33,13,15,9,6,2,17,0,,
1962,2,174,123,297,78,38,46,13,9,9,7,0,16,0,,
1962,7,195,127,322,107,62,32,9,13,16,6,3,25,0,,
1963,11,182,109,291,84,33,34,16,10,12,6,2,20,0,,
1963,16,201,113,314,103,34,28,10,16,14,6,2,22,0,,
1964,5,192,80,272,61,48,19,27,15,11,7,0,18,0,,
1964,9,187,136,323,74,54,47,15,27,16,12,1,29,0,,
1965,14,158,95,253,68,57,50,17,10,11,11,0,22,0,,
1965,10,146,92,238,68,47,39,11,17,9,7,1,17,0,,
1966,8,171,102,273,88,37,31,8,9,7,9,2,18,0,,
1966,18,176,117,293,83,43,43,9,8,15,13,2,30,0,,
1967,13,182,126,308,80,44,21,15,8,12,15,6,33,0,,
1967,1,163,111,274,90,54,24,8,15,7,7,5,19,0,,
1968,7,199,132,331,103,47,32,15,16,20,6,1,27,0,,
1968,3,155,118,273,73,54,34,16,15,14,7,1,22,0,,
1969,15,196,89,285,81,64,30,17,19,22,10,1,33,0,,
1969,8,169,119,288,93,43,34,19,17,9,8,1,18,0,,
1970,16,206,104,310,92,50,40,27,18,18,7,3,28,0,,
1970,10,165,130,295,59,47,28,18,27,14,6,1,21,0,,
1971,9,226,126,352,113,37,19,17,15,29,12,3,44,0,,
1971,11,153,121,274,69,24,42,15,17,6,7,5,18,0,,
1972,1,171,100,271,91,32,34,6,12,8,13,3,24,0,,
1972,5,202,117,319,107,29,14,12,6,17,11,2,30,0,,
1973,18,152,137,289,57,41,33,16,15,16,5,1,22,0,,
1973,4,181,130,311,90,49,23,15,16,9,20,2,31,0,,
1974,14,203,117,320,92,40,22,16,17,18,22,1,41,0,,
1974,12,168,95,263,76,54,31,17,16,11,7,1,19,0,,
1975,2,168,101,269,78,55,32,12,10,10,7,3,20,0,,
1975,13,195,104,299,92,42,37,10,12,19,10,2,31,0,,
1976,11,196,124,320,96,39,37,13,11,5,15,4,24,0,,
1976,15,156,115,271,58,44,22,11,13,5,9,3,17,0,,
1977,12,157,111,268,59,42,22,18,9,9,8,1,18,0,,
1977,16,198,128,326,105,55,35,9,18,16,14,1,31,0,,
1978,5,167,118,285,78,42,31,14,20,15,10,2,27,0,,
1978,2,198,97,295,98,26,24,20,14,14,14,0,28,0,,
1979,3,209,106,315,110,34,23,14,16,18,11,0,29,0,,
1979,18,182,124,306,94,28,30,16,14,11,9,4,24,0,,
1980,10,161,98,259,75,55,39,19,20,12,9,2,23,0,,
1980,9,157,83,240,50,55,47,20,19,7,8,1,16,0,,
1981,14,191,103,294,90,57,38,13,19,15,8,3,26,0,,
1981,7,174,113,287,72,58,37,19,13,15,4,0,19,0,,
1982,13,214,120,334,106,32,31,12,16,15,15,2,32,0,,
1982,8,188,121,309,86,45,39,16,12,9,7,2,18,0,,
1983,4,213,141,354,99,40,30,21,14,15,16,0,31,0,,
1983,1,166,116,282,78,46,28,14,21,8,7,2,17,0,,
1984,16,172,91,263,80,36,40,16,9,11,5,2,18,0,,
1984,5,201,125,326,90,47,11,9,16,14,17,4,35,0,,
1985,7,186,113,299,107,37,19,10,12,14,6,1,21,0,,
1985,11,147,87,234,66,40,45,12,10,10,8,0,18,0,,
1986,3,192,90,282,74,70,36,19,17,8,9,0,17,0,,
1986,12,196,73,269,49,64,40,17,19,10,12,2,24,0,,
1987,10,147,143,290,68,39,34,10,12,18,4,0,22,0,,
1987,15,175,78,253,70,62,40,12,10,17,16,0,33,0,,
1988,1,183,140,323,85,56,34,16,10,16,10,3,29,0,,
1988,8,193,111,304,98,53,48,10,16,19,2,4,25,0,,
1989,9,177,102,279,82,22,26,6,12,10,9,4,23,0,,
1989,4,218,132,350,110,36,34,12,6,12,14,1,27,0,,
1990,2,208,142,350,103,46,17,15,7,11,14,1,26,0,,
1990,14,206,143,349,107,33,31,7,15,16,16,2,34,0,,
1991,18,194,128,322,89,46,35,19,17,18,12,5,35,0,,
1991,13,170,94,264,83,59,33,17,19,6,13,3,22,0,,
1992,3,212,95,307,89,47,35,24,21,18,9,4,31,0,,
1992,5,210,111,321,104,34,28,21,24,13,9,0,22,0,,
1993,14,219,100,319,32,100,36,16,14,9,15,6,30,0,,
1993,16,196,72,268,28,98,51,14,16,3,5,2,10,0,,
1994,13,172,97,269,77,67,40,13,11,7,4,0,11,0,,
1994,10,165,153,318,78,69,39,11,13,10,6,1,17,0,,
1995,1,190,136,326,100,38,34,11,13,9,7,0,16,0,,
1995,18,200,148,348,98,52,37,13,11,23,6,3,32,0,,
1996,8,204,73,277,50,84,39,15,11,6,4,3,13,0,,
1996,9,200,118,318,52,68,42,11,15,8,11,7,26,0,,
1997,11,190,127,317,95,34,39,15,16,21,11,1,33,0,,
1997,2,168,109,277,83,42,12,16,15,13,7,1,21,0,,
1998,15,164,90,254,64,36,42,9,12,15,4,2,21,0,,
1998,7,198,144,342,105,40,33,12,9,23,7,2,32,0,,
1999,4,200,171,371,97,54,38,9,15,15,19,2,36,0,,
1999,12,171,86,257,67,31,23,15,9,6,10,3,19,0,,
2000,5,174,139,313,95,47,18,19,19,9,13,2,24,0,,
2000,18,178,145,323,89,34,36,19,19,16,10,1,27,0,,
206,3,211,110,321,98,22,11,0,0,16,14,1,31,0,,
267,1,172,82,254,47,17,20,0,0,10,10,1,21,0,,
287,3,188,109,297,74,26,20,0,0,15,9,2,26,0,,
385,8,184,69,253,45,24,18,0,0,8,7,2,17,0,,
401,3,187,127,314,75,26,25,0,0,12,17,1,30,0,,
436,9,169,109,278,57,42,23,0,0,15,6,2,23,0,,
699,18,182,109,291,62,18,22,0,0,13,10,5,28,0,,
823,18,187,115,302,76,20,33,20,29,18,14,1,33,0,,
999,8,188,116,304,79,25,25,16,21,11,9,1,21,0,,
1117,4,181,95,276,57,34,32,21,23,17,12,2,31,0,,
1173,14,185,96,281,71,49,28,16,21,12,6,0,18,0,,
1505,10,153,116,269,60,60,56,13,14,8,6,2,16,0,,
1578,3,199,83,282,96,28,25,13,15,17,13,3,33,0,,
1672,9,199,96,295,102,36,48,15,19,16,7,6,29,0,,
1740,1,175,131,306,62,24,27,15,4,19,8,2,29,0,,
1808,4,178,125,303,74,43,41,13,18,9,9,0,18,0,,
2001,12,190,130,320,74,41,19,12,9,14,8,1,23,0,,
2001,13,194,116,310,75,57,38,9,12,8,12,2,22,0,,
2002,11,179,97,276,73,36,43,10,8,15,15,4,34,0,,
2002,14,176,100,276,90,45,22,8,9,12,12,3,27,0,,
2003,10,157,66,223,76,45,55,18,10,17,5,3,25,0,,
2003,3,143,85,228,56,56,26,10,18,12,14,4,30,0,,
2004,1,185,137,322,93,25,34,9,12,21,10,0,31,0,,
2004,15,172,77,249,81,43,40,12,9,15,15,1,31,0,,
2005,9,187,126,313,75,58,36,13,19,20,10,0,30,0,,
2005,7,174,136,310,76,54,49,19,13,13,5,2,20,0,,
2006,8,191,94,285,63,62,53,13,11,16,11,2,29,0,,
2006,2,187,116,303,66,44,38,11,13,13,8,0,21,0,,
2007,4,200,131,331,84,57,30,15,19,13,8,7,28,0,,
2007,16,169,80,249,59,54,26,19,15,6,6,3,15,0,,
2008,5,213,130,343,105,35,24,24,25,16,8,3,27,0,,
2008,12,184,94,278,69,39,33,25,24,17,5,1,23,0,,
2009,2,163,96,259,89,47,15,10,13,6,5,3,14,0,,
2009,10,181,104,285,98,42,53,13,10,16,10,2,28,0,,
2010,4,199,169,368,77,55,48,12,8,15,16,1,32,0,,
2010,13,178,144,322,85,43,24,8,12,10,5,2,17,0,,
2011,9,210,145,355,96,42,32,18,10,26,13,1,40,0,,
2011,15,176,112,288,94,33,30,10,18,9,2,1,12,0,,
2012,7,186,141,327,92,34,29,13,12,17,5,5,27,0,,
2012,16,175,92,267,85,51,38,12,13,12,5,6,23,0,,
2013,11,156,71,227,66,50,33,15,18,9,4,2,15,0,,
2013,18,183,92,275,90,54,29,18,15,12,11,2,25,0,,
2014,3,209,120,329,100,45,20,14,13,17,9,2,28,0,,
2014,1,210,124,334,107,54,42,13,14,14,10,0,24,0,,
2015,14,223,143,366,106,35,39,11,17,17,17,4,38,0,,
2015,8,179,85,264,81,34,28,17,11,9,4,0,13,0,,
2016,9,190,144,334,79,41,20,11,16,23,10,1,34,0,,
2016,7,148,92,240,72,59,56,16,11,10,7,2,19,0,,
2017,13,209,101,310,109,53,25,12,14,15,7,2,24,0,,
2017,3,186,148,334,76,46,35,14,12,15,10,4,29,0,,
2018,10,181,93,274,69,55,35,17,17,11,7,2,20,0,,
2018,4,168,86,254,60,66,55,18,17,4,8,2,14,0,,
2019,18,197,95,292,87,47,34,22,10,18,6,3,27,0,,
2019,14,155,125,280,84,43,29,10,22,9,6,2,17,0,,
2020,7,188,81,269,70,76,45,15,16,16,8,3,27,0,,
2020,10,131,65,196,34,62,48,16,15,8,6,2,16,0,,
2021,14,236,112,348,83,44,32,20,16,10,12,2,24,0,,
2021,3,195,102,297,63,56,28,16,20,9,6,4,19,0,,
2022,18,156,78,234,66,50,40,19,14,14,7,3,24,0,,
2022,7,177,110,287,78,58,41,14,19,13,9,1,23,0,,
2023,9,193,93,286,96,42,23,16,20,12,10,2,24,0,,
2023,14,185,99,284,108,43,29,20,16,10,10,5,25,0,,
2024,18,200,95,295,95,36,28,13,17,17,10,1,28,0,,
2024,9,151,108,259,77,44,28,17,13,10,10,3,23,0,,
2025,9,168,136,304,67,54,40,15,19,18,6,2,26,0,,
2025,7,178,137,315,73,44,38,19,15,13,14,1,28,0,,
2026,15,220,96,316,117,30,24,19,25,16,5,4,25,0,,
2026,12,160,96,256,56,46,43,25,19,12,10,3,25,0,,
2027,16,215,107,322,116,29,27,21,27,13,8,2,23,0,,
2027,18,182,92,274,74,37,28,27,21,7,6,5,18,0,,
2028,13,204,112,316,97,31,30,18,22,15,12,1,28,0,,
2028,3,222,108,330,119,42,24,22,17,8,5,4,17,0,,
2029,10,172,106,278,78,57,33,26,21,18,9,1,28,0,,
2029,8,144,104,248,54,39,46,21,26,8,6,1,15,0,,
2030,11,186,106,292,83,39,30,18,19,7,11,0,18,0,,
2030,4,194,114,308,90,41,26,19,18,9,7,3,19,0,,
2031,2,159,124,283,71,32,29,18,13,15,3,5,23,0,,
2031,14,254,100,354,146,43,25,13,17,25,8,2,35,0,,
2032,5,211,134,345,113,28,21,13,19,11,8,6,25,0,,
2032,1,225,120,345,128,34,36,19,13,16,10,5,31,0,,
2033,12,180,101,281,69,59,47,16,12,16,13,1,30,0,,
2033,3,207,97,304,115,43,26,12,16,17,4,0,21,0,,
2034,15,198,80,278,101,43,22,23,10,12,9,1,22,0,,
2034,10,158,111,269,81,23,36,10,23,7,15,2,24,0,,
2035,1,202,136,338,99,27,23,28,19,15,18,1,34,0,,
2035,13,209,100,309,104,40,35,19,28,20,14,3,37,0,,
2036,4,210,98,308,114,38,36,18,15,12,9,3,24,0,,
2036,14,197,134,331,89,39,23,15,18,8,11,3,22,0,,
2037,18,207,108,315,102,43,41,19,22,11,7,2,20,0,,
2037,9,172,103,275,62,56,21,22,19,11,6,1,18,0,,
2038,7,191,124,315,87,36,40,14,20,8,9,2,19,0,,
2038,16,177,93,270,88,53,19,20,14,8,5,5,18,0,,
2039,5,231,120,351,116,42,29,16,8,10,14,1,25,0,,
2039,11,182,134,316,81,39,27,8,16,12,9,0,21,0,,
2040,8,185,113,298,91,55,30,16,22,12,14,3,29,0,,
2040,2,181,104,285,97,35,35,22,16,16,7,0,23,0,,
2041,13,190,96,286,80,42,23,16,18,18,4,2,24,0,,
2041,14,207,128,335,106,32,41,18,16,8,17,1,26,0,,
2042,12,173,93,266,57,39,45,29,17,16,11,1,28,0,,
2042,5,217,113,330,102,45,21,17,29,20,6,2,28,0,,
2043,7,179,101,280,86,34,23,22,19,14,9,0,23,0,,
2043,15,189,87,276,77,54,36,19,22,15,9,1,25,0,,
2044,16,196,94,290,107,39,23,22,17,12,5,3,20,0,,
2044,4,204,97,301,100,31,20,17,22,12,8,8,28,0,,
2045,9,162,76,238,71,62,24,21,28,11,9,6,26,0,,
2045,10,169,120,289,66,43,33,28,21,13,8,1,22,0,,
2046,11,223,131,354,111,35,25,21,18,18,9,7,34,0,,
2046,18,170,107,277,78,38,28,18,21,8,5,3,16,0,,
2047,3,226,79,305,107,55,16,25,21,10,12,5,27,0,,
2047,8,185,131,316,77,44,38,21,25,11,8,1,20,0,,
2048,1,225,129,354,133,39,27,13,14,11,16,1,28,0,,
2048,2,225,127,352,119,28,26,14,13,12,13,2,27,0,,
2049,15,229,96,325,109,41,31,9,12,14,7,2,23,0,,
2049,5,186,112,298,78,32,25,12,9,13,10,2,25,0,,
2050,8,218,169,387,111,44,41,22,15,18,6,1,25,0,,
2050,9,146,83,229,54,52,34,15,22,10,6,3,19,0,,
2051,4,213,168,381,73,45,35,17,15,21,16,1,38,0,,
2051,1,208,117,325,114,50,30,15,17,17,5,0,22,0,,
2052,14,223,125,348,106,54,26,17,15,19,14,3,36,0,,
2052,3,187,99,286,90,39,21,15,17,11,8,1,20,0,,
2053,18,194,120,314,86,47,33,13,17,15,14,5,34,0,,
2053,12,177,81,258,71,56,30,18,13,16,12,1,29,0,,
2054,10,152,104,256,69,43,37,20,22,11,12,1,24,0,,
2054,11,168,112,280,73,33,33,22,20,18,11,1,30,0,,
2055,2,212,148,360,114,28,22,16,17,14,14,2,30,0,,
2055,16,215,123,338,126,43,27,17,16,7,8,2,17,0,,
2056,7,200,119,319,92,37,31,17,14,23,10,3,36,0,,
2056,13,158,98,256,77,40,37,14,17,15,9,5,29,0,,
2057,18,194,103,297,93,37,39,23,14,15,5,0,20,0,,
2057,14,187,116,303,72,43,23,14,23,15,8,1,24,0,,
2058,16,217,133,350,105,69,28,12,20,15,13,0,28,0,,
2058,12,187,121,308,79,33,29,20,12,11,14,4,29,0,,
2059,15,187,86,273,86,32,32,19,18,16,12,0,28,0,,
2059,8,202,119,321,110,42,28,18,19,13,11,0,24,0,,
2060,10,158,142,300,64,55,40,17,14,7,12,6,25,0,,
2060,13,187,67,254,74,74,35,14,17,14,9,1,24,0,,
2061,1,207,170,377,93,46,28,16,14,21,12,1,34,0,,
2061,11,165,118,283,74,41,37,14,16,16,10,3,29,0,,
2062,9,173,84,257,80,63,21,11,18,12,11,1,24,0,,
2062,4,226,135,361,115,25,42,18,11,23,15,4,42,0,,
2063,7,207,133,340,110,43,29,15,13,22,14,1,37,0,,
2063,2,164,119,283,79,35,36,13,15,11,12,1,24,0,,
2064,3,227,92,319,121,35,25,11,12,11,14,3,28,0,,
2064,5,201,137,338,99,38,31,12,11,10,8,1,19,0,,
2065,12,166,107,273,66,47,28,17,18,13,9,2,24,0,,
2065,8,204,105,309,111,48,45,18,17,12,9,2,23,0,,
2066,11,187,115,302,66,61,57,14,9,10,10,3,23,0,,
2066,15,204,100,304,84,47,19,9,14,10,3,1,14,0,,
2067,13,174,73,247,77,31,48,21,17,20,6,3,29,0,,
2067,16,206,117,323,102,32,14,17,21,22,9,2,33,0,,
2068,4,215,113,328,69,68,64,23,18,15,9,5,29,0,,
2068,10,170,88,258,42,90,20,19,23,8,8,3,19,0,,
2069,3,202,113,315,93,37,27,12,10,12,14,2,28,0,,
2069,9,204,114,318,117,36,35,10,12,21,3,7,31,0,,
2070,14,199,136,335,97,38,31,16,16,16,10,2,28,0,,
2070,1,192,122,314,104,44,28,16,16,11,6,1,18,0,,
2071,5,177,123,300,80,50,23,19,16,10,10,1,21,0,,
2071,7,201,144,345,92,57,41,16,19,16,12,1,29,0,,
2072,2,217,109,326,122,34,33,20,10,19,5,2,26,0,,
2072,18,181,107,288,103,33,21,10,20,9,11,2,22,0,,
2073,13,185,95,280,95,52,29,14,9,11,9,3,23,0,,
2073,11,179,131,310,82,33,31,9,14,7,10,2,19,0,,
2074,14,180,127,307,95,38,36,13,23,18,8,3,29,0,,
2074,7,158,134,292,76,52,25,23,13,15,8,3,26,0,,
2075,2,212,183,395,103,39,38,14,13,23,10,1,34,0,,
2075,12,177,127,304,69,46,29,13,14,10,5,1,16,0,,
2076,9,183,99,282,71,29,33,18,7,12,6,9,27,0,,
2076,1,221,144,365,118,26,31,7,18,15,17,3,35,0,,
2077,10,173,120,293,64,37,32,17,13,13,15,1,29,0,,
2077,3,174,81,255,86,43,36,13,17,14,3,1,18,0,,
2078,8,203,149,352,112,33,27,9,12,12,4,1,17,0,,
2078,4,200,125,325,93,33,40,12,9,14,11,1,26,0,,
2079,18,218,117,335,123,33,43,11,17,18,11,0,29,0,,
2079,15,166,73,239,72,39,19,17,11,10,11,1,22,0,,
2080,16,230,160,390,113,34,48,13,11,28,11,1,40,0,,
2080,5,158,106,264,54,21,20,11,13,10,5,3,18,0,,
2081,12,147,111,258,59,44,28,19,12,10,8,5,23,0,,
2081,14,189,141,330,97,42,36,12,19,22,9,2,33,0,,
2082,8,236,126,362,130,25,40,19,20,19,14,0,33,0,,
2082,13,192,76,268,95,36,21,21,19,13,8,3,24,0,,
2083,4,186,120,306,79,41,39,15,15,13,9,1,23,0,,
2083,7,167,119,286,84,50,34,15,15,7,9,1,17,0,,
2084,11,217,149,366,76,49,48,11,9,8,10,3,21,0,,
2084,9,183,117,300,74,65,25,9,11,11,4,2,17,0,,
2085,15,189,111,300,88,36,31,12,10,13,10,4,27,0,,
2085,1,183,134,317,115,40,29,10,12,18,6,3,27,0,,
2086,10,169,100,269,87,58,29,10,12,9,13,2,24,0,,
2086,18,166,95,261,84,34,40,12,10,6,7,2,15,0,,
2087,5,190,121,311,92,47,14,15,16,8,9,1,18,0,,
2087,2,220,130,350,110,31,36,16,15,13,12,1,26,0,,
2088,3,223,91,314,128,32,13,7,7,17,12,3,32,0,,
2088,16,179,107,286,86,40,34,7,7,11,14,2,27,0,,
2089,7,181,124,305,82,39,27,20,14,8,7,2,17,0,,
2089,11,190,176,366,104,40,27,14,20,15,11,2,28,0,,
2090,12,181,101,282,79,35,13,16,16,13,13,1,27,0,,
2090,13,211,114,325,109,47,29,16,16,15,17,3,35,0,,
2091,5,198,117,315,97,54,22,16,19,18,7,3,28,0,,
2091,4,190,104,294,101,29,38,19,16,15,5,0,20,0,,
2092,9,189,104,293,94,46,32,11,10,12,7,4,23,0,,
2092,2,210,122,332,109,29,39,10,11,12,10,1,23,0,,
2093,18,226,128,354,117,40,38,16,22,12,7,6,25,0,,
2093,3,208,100,308,92,46,21,22,16,9,11,1,21,0,,
2094,1,178,113,291,76,44,32,25,15,10,11,5,26,0,,
2094,10,166,123,289,70,39,35,16,25,13,11,0,24,0,,
2095,14,215,169,384,92,46,42,16,20,22,13,1,36,0,,
2095,15,162,111,273,57,39,34,20,16,8,11,2,21,0,,
2096,16,141,91,232,55,47,40,17,14,10,9,1,20,0,,
2096,8,215,142,357,106,46,28,14,17,18,14,2,34,0,,
2097,13,201,95,296,112,36,18,13,19,20,9,2,31,0,,
2097,2,169,120,289,78,46,38,19,13,11,7,1,19,0,,
2098,14,162,99,261,75,50,27,18,14,11,10,6,27,0,,
2098,16,207,103,310,125,54,28,15,18,14,5,2,21,0,,
2099,8,191,157,348,95,31,43,14,22,12,7,1,20,0,,
2099,5,193,97,290,86,49,29,22,14,17,4,2,23,0,,
2100,9,156,116,272,74,24,35,12,14,13,12,3,28,0,,
2100,15,217,119,336,110,23,33,14,12,17,7,3,27,0,,
2101,7,166,96,262,71,48,32,18,10,15,10,1,26,0,,
2101,10,153,102,255,73,45,36,10,18,8,8,2,18,0,,
2102,11,172,138,310,79,36,38,14,15,9,12,3,24,0,,
2102,12,189,103,292,106,57,15,15,14,8,6,3,17,0,,
2103,3,206,124,330,104,47,33,15,19,21,10,1,32,0,,
2103,1,191,156,347,86,35,23,19,15,17,7,1,25,0,,
2104,4,238,117,355,126,17,22,19,16,27,15,2,44,0,,
2104,18,180,105,285,90,33,22,16,18,9,7,1,17,0,,
2105,5,238,115,353,119,37,22,24,20,18,12,1,31,0,,
2105,14,210,136,346,107,32,31,20,24,14,11,1,26,0,,
2106,12,161,87,248,73,50,22,21,16,14,5,2,21,0,,
2106,10,180,120,300,87,43,42,16,21,18,6,2,26,0,,
2107,2,183,137,320,96,28,21,15,12,15,10,3,28,0,,
2107,4,215,110,325,121,43,30,12,15,15,11,4,30,0,,
2108,16,188,138,326,90,41,41,14,23,10,6,1,17,0,,
2108,9,196,124,320,93,51,25,23,14,15,11,5,31,0,,
2109,11,214,162,376,100,36,40,19,11,24,5,1,30,0,,
2109,3,194,95,289,106,47,21,11,19,9,6,3,18,0,,
2110,15,196,114,310,94,39,28,15,17,11,8,6,25,0,,
2110,13,207,107,314,112,38,28,17,15,17,13,1,31,0,,
2111,7,173,112,285,84,46,20,25,17,11,11,4,26,0,,
2111,18,185,123,308,111,30,27,17,25,16,7,1,24,0,,
2112,1,187,134,321,86,49,22,22,19,17,6,3,26,0,,
2112,8,191,144,335,99,41,38,19,22,13,8,3,24,0,,
2113,4,217,129,346,70,53,44,19,19,15,15,1,31,0,,
2113,3,197,119,316,55,58,25,19,19,12,9,1,22,0,,
2114,8,194,136,330,100,35,25,18,19,8,4,2,14,0,,
2114,7,203,138,341,114,39,21,19,18,15,8,2,25,0,,
2115,12,177,98,275,80,41,14,19,17,12,10,0,22,0,,
2115,9,207,132,339,116,42,45,18,19,21,10,4,35,0,,
2116,18,203,163,366,102,42,40,17,21,17,13,3,33,0,,
2116,1,195,134,329,86,39,26,21,17,15,12,1,28,0,,
2117,10,186,123,309,76,53,34,15,13,16,12,1,29,0,,
2117,16,166,106,272,76,33,40,15,15,10,9,2,21,0,,
2118,14,209,159,368,109,48,22,12,17,9,6,1,16,0,,
2118,11,169,187,356,77,55,33,17,12,8,8,1,17,0,,
2119,15,194,100,294,112,39,22,12,13,17,6,1,24,0,,
2119,2,190,136,326,102,18,24,13,12,10,18,2,30,0,,
2120,13,219,106,325,105,43,42,13,17,17,12,3,32,0,,
2120,5,196,118,314,73,42,26,17,13,10,10,2,22,0,,
2121,18,217,147,364,101,30,31,21,14,29,13,1,43,0,,
2121,8,181,111,292,97,39,29,14,21,10,10,1,21,0,,
2122,13,198,105,303,97,39,18,19,14,13,10,2,25,0,,
2122,4,198,125,323,85,46,48,14,19,15,12,3,30,0,,
2123,2,145,124,269,81,46,30,21,15,9,8,0,17,0,,
2123,11,165,141,306,86,61,24,15,20,20,9,3,32,0,,
2124,1,217,154,371,114,46,31,14,12,17,13,1,31,0,,
2124,12,197,114,311,97,31,20,12,14,10,8,2,20,0,,
2125,9,218,129,347,86,63,42,20,13,17,11,3,31,0,,
2125,14,180,106,286,64,58,24,13,20,6,8,3,17,0,,
2126,16,176,118,294,99,38,18,14,24,6,4,4,14,0,,
2126,15,202,104,306,114,41,27,24,14,8,17,1,26,0,,
2127,3,203,135,338,102,48,24,13,11,19,5,0,24,0,,
2127,7,196,107,303,105,37,32,11,13,16,5,3,24,0,,
2128,10,200,96,296,99,49,29,19,30,11,8,3,22,0,,
2128,5,193,128,321,82,42,27,30,19,10,14,2,26,0,,
2129,5,221,98,319,115,49,10,23,11,14,17,1,32,0,,
2129,18,179,130,309,106,30,34,12,23,9,17,0,26,0,,
2130,2,201,119,320,111,48,27,23,15,12,11,2,25,0,,
2130,10,172,108,280,87,48,30,15,23,12,8,4,24,0,,
2131,4,221,152,373,114,40,45,10,12,21,11,2,34,0,,
2131,12,156,78,234,78,52,18,12,10,9,7,1,17,0,,
2132,3,177,117,294,105,21,39,12,15,13,6,2,21,0,,
2132,15,203,100,303,108,53,24,16,12,19,11,3,33,0,,
2133,13,181,83,264,88,34,31,11,16,13,12,2,27,0,,
2133,9,197,143,340,102,41,33,16,11,25,15,0,40,0,,
2134,11,193,137,330,102,47,22,13,25,14,7,3,24,0,,
2134,16,173,164,337,92,30,31,25,13,14,3,1,18,0,,
2135,14,209,127,336,107,40,24,22,12,16,9,8,33,0,,
2135,8,206,111,317,111,34,28,12,22,8,8,2,18,0,,
2136,1,174,118,292,95,54,26,22,18,15,6,2,23,0,,
2136,7,224,138,362,128,38,30,19,22,17,11,3,31,0,,
2137,15,205,123,328,73,38,24,28,16,14,12,1,27,0,,
2137,4,227,110,337,117,29,31,16,28,15,6,5,26,0,,
2138,18,188,139,327,99,35,30,19,21,20,14,3,37,0,,
2138,13,178,87,265,100,34,26,22,19,11,7,2,20,0,,
2139,2,219,100,319,94,64,50,27,18,14,6,2,22,0,,
2139,3,201,92,293,84,58,15,18,26,9,10,2,21,0,,
2140,9,232,122,354,130,40,27,11,21,19,15,4,38,0,,
2140,5,190,105,295,86,28,19,21,11,7,9,4,20,0,,
2141,10,187,100,287,87,45,40,13,25,16,9,0,25,0,,
2141,14,170,113,283,77,58,17,25,13,7,9,0,16,0,,
2142,8,169,135,304,89,49,24,25,17,10,6,2,18,0,,
2142,11,194,135,329,109,49,36,17,25,12,4,2,18,0,,
2143,7,184,143,327,72,58,47,17,20,23,11,4,38,0,,
2143,12,166,120,286,88,39,30,20,17,11,6,1,18,0,,
2144,16,199,159,358,111,44,34,16,17,22,11,2,35,0,,
2144,1,168,151,319,70,45,25,17,15,13,12,2,27,0,,
2145,5,185,105,290,75,54,38,18,18,15,15,0,30,0,,
2145,3,209,100,309,89,38,24,18,18,21,5,0,26,0,,
2146,14,231,146,377,107,61,22,27,18,18,11,7,36,0,,
2146,18,155,102,257,54,66,46,18,27,7,4,1,12,0,,
2147,2,163,114,277,54,62,59,20,23,5,6,1,12,0,,
2147,7,201,115,316,80,55,15,23,20,16,8,2,26,0,,
2148,4,213,128,341,96,36,35,24,20,17,8,1,26,0,,
2148,9,175,91,266,79,43,25,20,23,13,10,0,23,0,,
2149,13,167,79,246,70,66,32,18,16,11,8,4,23,0,,
2149,10,173,87,260,72,52,36,16,18,16,4,4,24,0,,
2150,11,187,146,333,90,43,37,17,17,16,10,2,28,0,,
2150,1,159,158,317,77,44,22,17,17,5,4,1,10,0,,
2151,12,212,110,322,98,39,15,17,15,17,13,2,32,0,,
2151,16,192,166,358,84,27,33,15,17,24,7,1,32,0,,
2152,8,184,146,330,75,37,46,18,21,10,5,3,18,0,,
2152,15,233,136,369,114,41,22,21,18,16,10,3,29,0,,
2153,7,208,108,316,100,44,38,22,21,21,15,2,38,0,,
2153,5,198,106,304,101,37,24,21,21,10,7,3,20,0,,
2154,8,210,171,381,111,30,31,11,22,19,10,3,32,0,,
2154,12,191,94,285,86,50,24,22,11,15,12,1,28,0,,
2155,1,215,163,378,100,53,24,14,20,20,11,0,31,0,,
2155,14,194,137,331,97,41,26,20,14,14,11,3,28,0,,
2156,9,205,126,331,107,37,31,18,24,17,12,0,29,0,,
2156,3,188,113,301,84,39,24,24,17,14,12,5,31,0,,
2157,18,180,125,305,86,45,33,16,29,14,10,2,26,0,,
2157,2,195,116,311,83,61,31,29,16,12,4,7,23,0,,
2158,10,169,99,268,80,49,29,15,19,13,8,2,23,0,,
2158,4,170,130,300,73,49,35,19,15,9,9,4,22,0,,
2159,15,192,124,316,86,51,25,17,13,16,10,3,29,0,,
2159,11,182,123,305,91,34,40,13,17,19,7,1,27,0,,
2160,16,206,95,301,67,75,52,29,13,15,10,1,26,0,,
2160,13,198,108,306,91,68,28,13,29,11,6,4,21,0,,
2161,3,195,93,288,89,46,25,16,16,16,8,3,27,0,,
2161,14,202,126,328,89,49,43,16,16,13,12,4,29,0,,
2162,13,168,105,273,63,51,40,21,27,13,8,2,23,0,,
2162,7,217,145,362,96,59,26,27,20,27,9,5,41,0,,
2163,4,203,115,318,109,36,33,21,14,12,21,4,37,0,,
2163,8,157,166,323,85,43,30,15,21,7,7,0,14,0,,
2164,11,182,88,270,70,82,38,19,18,8,3,3,14,0,,
2164,10,191,108,299,71,72,39,18,19,6,9,2,17,0,,
2165,1,197,159,356,87,48,37,11,19,23,11,1,35,0,,
2165,9,181,120,301,81,40,22,19,10,18,11,4,33,0,,
2166,15,188,88,276,107,41,24,21,11,15,9,1,25,0,,
2166,18,189,123,312,84,28,39,11,21,14,8,4,26,0,,
2167,12,196,100,296,102,59,31,20,14,22,7,2,31,0,,
2167,2,175,123,298,77,41,39,14,20,16,9,1,26,0,,
2168,5,195,104,299,81,28,25,21,19,12,10,3,25,0,,
2168,16,202,123,325,102,41,32,19,21,15,7,1,23,0,,
2169,7,217,109,326,114,40,28,24,17,13,14,4,31,0,,
2169,14,171,120,291,90,50,24,17,24,8,4,3,15,0,,
2170,11,179,137,316,65,44,48,22,23,13,18,1,32,0,,
2170,13,185,97,282,91,62,29,23,22,7,2,2,11,0,,
2171,1,192,163,355,90,36,25,17,25,21,13,0,34,0,,
2171,4,176,119,295,85,38,29,25,16,14,13,0,27,0,,
2172,16,206,138,344,102,56,25,17,21,13,11,4,28,0,,
2172,2,199,131,330,74,40,34,21,17,9,11,1,21,0,,
2173,3,175,97,272,67,38,27,24,15,15,6,2,23,0,,
2173,10,184,102,286,72,46,33,16,24,18,8,2,28,0,,
2174,9,205,144,349,79,43,36,15,16,18,11,2,31,0,,
2174,8,192,168,360,97,41,39,16,15,11,14,0,25,0,,
2175,12,187,73,260,83,59,20,17,17,16,8,5,29,0,,
2175,18,193,111,304,84,42,40,17,17,18,13,2,33,0,,
2176,5,194,107,301,91,39,18,20,14,14,12,2,28,0,,
2176,15,185,112,297,90,36,37,14,20,15,13,1,29,0,,
2177,4,234,123,357,104,41,31,26,14,19,9,5,33,0,,
2177,16,174,101,275,78,43,35,14,26,12,7,1,20,0,,
2178,15,158,91,249,82,40,32,24,26,13,4,3,20,0,,
2178,7,184,96,280,91,32,34,26,23,16,11,1,28,0,,
2179,14,185,118,303,97,50,25,19,22,15,9,0,24,0,,
2179,13,180,93,273,73,47,34,23,19,14,12,4,30,0,,
2180,18,211,134,345,107,45,33,23,17,12,7,2,21,0,,
2180,11,194,141,335,96,39,14,17,23,13,6,2,21,0,,
2181,5,189,98,287,93,47,22,17,15,14,8,2,24,0,,
2181,12,214,116,330,97,33,41,15,17,19,12,3,34,0,,
2182,10,233,113,346,127,29,51,17,24,19,8,2,29,0,,
2182,9,161,80,241,84,54,19,24,16,6,3,1,10,0,,
2183,8,213,155,368,109,42,38,19,16,17,13,2,32,0,,
2183,3,186,108,294,84,40,22,16,19,16,8,0,24,0,,
2184,2,199,135,334,82,45,35,25,16,16,9,2,27,0,,
2184,1,169,134,303,66,63,37,16,25,18,8,3,29,0,,
2185,16,173,112,285,80,57,39,18,15,12,5,3,20,0,,
2185,7,203,95,298,102,51,28,15,18,11,9,0,20,0,,
2186,11,204,167,371,90,35,31,19,8,22,17,2,41,0,,
2186,5,209,111,320,120,52,29,8,19,5,8,3,16,0,,
2187,14,239,135,374,115,66,18,17,17,16,9,4,29,0,,
2187,4,159,138,297,69,48,47,17,17,5,3,0,8,0,,
2188,9,177,86,263,92,31,21,20,11,7,7,2,16,0,,
2188,18,260,118,378,158,22,18,11,20,11,12,3,26,0,,
2189,13,189,99,288,90,36,31,22,16,16,12,1,29,0,,
2189,1,185,122,307,90,43,23,16,22,16,8,0,24,0,,
2190,10,197,109,306,99,43,33,21,20,15,10,1,26,0,,
2190,15,160,93,253,62,50,30,20,21,9,9,1,19,0,,
2191,3,209,135,344,92,40,23,22,12,28,14,0,42,0,,
2191,12,185,92,277,93,36,42,12,22,11,16,1,28,0,,
2192,2,182,128,310,77,58,41,25,14,20,13,4,37,0,,
2192,8,173,125,298,85,43,29,14,25,21,6,1,28,0,,
2193,1,196,135,331,91,48,40,18,16,21,12,3,36,0,,
2193,5,224,132,356,104,32,25,16,18,14,9,7,30,0,,
2194,8,137,142,279,50,61,38,16,15,11,8,1,20,0,,
2194,10,193,98,291,86,56,37,15,16,20,9,0,29,0,,
2195,4,199,121,320,107,41,23,23,22,10,9,5,24,0,,
2195,11,184,124,308,99,31,26,22,23,12,7,3,22,0,,
2196,18,203,129,332,102,40,24,20,13,18,7,5,30,0,,
2196,16,179,120,299,93,41,32,13,20,11,7,2,20,0,,
2197,7,217,154,371,108,46,22,27,15,28,14,4,46,0,,
2197,9,152,86,238,95,49,41,15,27,7,5,0,12,0,,
2198,14,184,130,314,105,50,29,6,13,10,9,0,19,0,,
2198,2,208,121,329,127,52,28,13,6,10,6,2,18,0,,
2199,12,165,126,291,56,45,30,17,14,12,5,6,23,0,,
2199,15,204,151,355,95,60,26,14,17,17,10,1,28,0,,
2200,3,188,127,315,70,51,25,15,21,12,10,3,25,0,,
2200,13,203,105,308,74,56,36,21,15,13,15,2,30,0,,
2201,4,181,110,291,62,46,45,21,14,10,8,1,19,0,,
2201,10,180,101,281,63,53,42,14,21,10,5,0,15,0,,
2204,14,242,111,353,136,41,31,19,21,18,7,1,26,0,,
2204,13,162,106,268,79,54,27,21,19,9,5,2,16,0,,
2205,11,186,113,299,73,64,47,14,17,8,6,3,17,0,,
2205,7,214,129,343,102,67,22,17,14,10,4,1,15,0,,
2206,15,166,87,253,69,46,28,16,15,11,8,3,22,0,,
2206,18,223,128,351,126,31,40,15,16,26,8,0,34,0,,
2207,10,155,111,266,50,66,66,16,17,7,9,5,21,0,,
2207,14,177,93,270,79,83,22,17,16,7,8,3,18,0,,
2208,11,188,118,306,105,48,32,17,20,18,10,4,32,0,,
2208,18,161,117,278,80,43,30,20,17,5,7,3,15,0,,
2210,7,157,98,255,65,64,42,19,11,9,9,2,20,0,,
2210,10,196,76,272,91,73,37,11,19,15,2,4,21,0,,
2211,4,204,142,346,91,52,36,15,8,14,6,3,23,0,,
2211,11,184,127,311,82,50,31,8,15,11,9,2,22,0,,
2212,10,188,105,293,84,62,29,12,13,8,10,0,18,0,,
2212,4,181,104,285,68,59,43,13,12,7,8,4,19,0,,
2389,4,199,161,360,86,51,41,12,18,11,15,3,29,0,,
2389,7,201,106,307,108,66,22,19,12,9,10,2,21,0,,
2390,1,237,128,365,134,48,25,18,15,25,14,3,42,0,,
2390,2,183,148,331,110,53,26,16,18,7,7,1,15,0,,
2391,14,241,150,391,105,44,23,20,22,17,12,1,30,0,,
2391,9,174,114,288,83,49,28,22,19,5,5,3,13,0,,
2392,3,209,133,342,96,50,20,23,18,17,5,1,23,0,,
2392,10,193,111,304,93,44,30,18,23,12,9,0,21,0,,
2393,18,182,135,317,99,36,36,16,31,13,7,2,22,0,,
2393,15,198,124,322,87,47,19,31,14,19,8,6,33,0,,
2394,8,221,169,390,118,27,22,15,14,17,4,3,24,0,,
2394,16,258,113,371,170,35,21,14,15,13,8,1,22,0,,
2395,13,203,151,354,105,48,30,9,18,10,8,4,22,0,,
2395,12,259,102,361,142,43,26,18,9,13,12,3,28,0,,
2396,5,207,140,347,102,47,31,16,11,12,5,0,17,0,,
2396,11,246,145,391,146,32,35,11,16,17,9,0,26,0,,
2397,2,194,133,327,107,60,33,15,16,11,11,0,22,0,,
2397,7,205,100,305,102,53,21,16,15,13,8,2,23,0,,
2398,14,227,124,351,113,45,33,20,22,22,6,0,28,0,,
2398,15,182,148,330,87,46,32,22,20,10,9,0,19,0,,
2399,1,189,124,313,91,52,29,19,19,20,14,3,37,0,,
2399,13,189,101,290,89,46,39,19,19,12,11,7,30,0,,
2400,9,212,135,347,106,49,35,16,14,17,11,2,30,0,,
2400,3,215,121,336,118,37,29,14,16,15,5,2,22,0,,
2401,16,212,186,398,103,38,39,15,21,15,7,4,26,0,,
2401,12,218,102,320,107,48,29,21,14,13,6,2,21,0,,
2402,10,171,129,300,76,40,22,16,20,11,10,4,25,0,,
2402,18,210,95,305,110,50,43,20,16,15,14,2,31,0,,
2403,8,178,140,318,85,31,36,13,18,12,8,4,24,0,,
2403,5,247,138,385,137,52,25,18,13,18,9,2,29,0,,
2404,11,193,150,343,101,49,21,19,20,13,9,1,23,0,,
2404,4,214,171,385,115,57,37,20,19,13,12,0,25,0,,
2405,7,212,103,315,120,57,29,16,17,19,7,3,29,0,,
2405,9,179,102,281,97,46,25,17,16,12,13,2,27,0,,
2406,14,196,96,292,99,47,24,22,16,6,12,1,19,0,,
2406,8,232,164,396,120,48,38,16,22,15,11,0,26,0,,
2407,12,158,87,245,60,52,36,22,14,11,6,2,19,0,,
2407,10,224,142,366,135,59,43,14,22,12,8,1,21,0,,
2408,4,238,170,408,128,46,31,12,10,20,12,4,36,0,,
2408,2,175,128,303,93,41,21,10,12,14,5,1,20,0,,
2409,13,222,127,349,102,57,28,19,20,14,10,3,27,0,,
2409,11,194,151,345,89,57,50,20,19,15,11,1,27,0,,
2410,3,193,155,348,96,52,21,13,10,13,13,2,28,0,,
2410,1,221,134,355,134,43,44,10,13,15,11,3,29,0,,
2411,18,200,119,319,99,44,29,22,17,11,10,3,24,0,,
2411,16,214,121,335,128,49,30,17,22,15,16,4,35,0,,
2412,15,181,136,317,93,45,22,11,15,11,8,2,21,0,,
2412,5,235,123,358,122,46,28,15,11,23,11,4,38,0,,
2413,12,213,134,347,124,50,27,16,12,9,10,4,23,0,,
2413,8,241,148,389,151,38,31,12,16,15,9,1,25,0,,
2414,1,162,106,268,64,59,39,26,18,14,11,2,27,0,,
2414,14,213,119,332,102,64,33,18,26,14,11,2,27,0,,
2415,9,188,95,283,98,69,30,14,18,11,12,4,27,0,,
2415,2,210,119,329,107,43,27,18,14,14,10,2,26,0,,
2416,16,190,148,338,113,48,37,17,17,9,5,0,14,0,,
2416,11,217,145,362,107,62,26,17,17,9,13,3,25,0,,
2417,15,225,100,325,112,48,24,21,17,10,10,1,21,0,,
2417,4,197,101,298,104,35,22,17,20,14,7,4,25,0,,
2418,10,199,91,290,95,49,44,18,16,13,10,4,27,0,,
2418,13,191,81,272,91,61,33,16,18,15,5,2,22,0,,
2419,18,209,127,336,117,43,33,22,15,19,7,1,27,0,,
2419,7,199,102,301,108,47,22,15,22,18,8,2,28,0,,
2420,5,239,119,358,129,48,33,16,11,15,14,2,31,0,,
2420,3,205,137,342,119,50,31,11,16,12,15,2,29,0,,
2421,2,212,124,336,110,30,23,13,12,12,18,2,32,0,,
2421,12,238,118,356,124,42,26,12,13,11,15,3,29,0,,
2422,13,184,105,289,99,58,32,9,14,13,8,4,25,0,,
2422,15,221,104,325,134,50,22,14,9,12,10,4,26,0,,
2423,11,194,169,363,87,34,33,14,12,20,6,6,32,0,,
2423,1,206,168,374,119,52,27,12,14,7,12,1,20,0,,
2424,10,186,81,267,78,63,33,17,23,15,13,4,32,0,,
2424,14,181,93,274,93,59,57,23,17,13,3,4,20,0,,
2425,4,211,143,354,97,51,28,20,10,18,10,4,32,0,,
2425,9,232,125,357,142,51,34,10,19,9,8,1,18,0,,
2426,7,199,128,327,110,56,23,27,15,13,11,4,28,0,,
2426,16,200,112,312,109,58,42,15,27,14,8,2,24,0,,
2427,5,226,129,355,119,39,23,19,16,18,10,2,30,0,,
2427,18,221,159,380,126,35,31,16,19,11,6,7,24,0,,
2428,8,224,131,355,120,55,45,12,18,12,9,3,24,0,,
2428,3,228,121,349,121,50,12,18,12,12,7,4,23,0,,
2429,13,222,111,333,91,85,36,16,17,13,6,3,22,0,,
2429,14,192,117,309,55,58,37,17,16,11,11,4,26,0,,
2430,7,215,133,348,112,47,27,24,26,14,5,3,22,0,,
2430,1,181,110,291,89,43,45,26,24,12,5,1,18,0,,
2431,16,233,127,360,136,60,21,16,23,12,12,4,28,0,,
2431,4,193,128,321,74,55,46,23,16,12,9,2,23,0,,
2432,3,219,124,343,106,50,20,12,9,13,13,4,30,0,,
2432,2,220,152,372,107,37,19,9,12,13,18,1,32,0,,
2433,11,201,124,325,81,56,36,23,19,15,8,5,28,0,,
2433,18,228,102,330,108,63,40,21,23,8,5,0,13,0,,
2434,9,198,88,286,89,71,40,26,19,10,7,3,20,0,,
2434,10,186,105,291,85,55,24,19,26,15,9,3,27,0,,
2435,12,214,109,323,111,46,36,15,11,9,11,1,21,0,,
2435,5,245,139,384,122,49,23,11,15,21,9,3,33,0,,
2436,15,226,131,357,129,44,20,18,13,15,10,2,27,0,,
2436,8,208,155,363,121,47,43,13,18,11,13,1,25,0,,
2437,7,210,121,331,124,56,13,8,14,9,10,0,19,0,,
2437,14,219,151,370,122,39,35,14,8,12,9,1,22,0,,
2438,13,248,99,347,142,61,39,19,16,17,10,5,32,0,,
2438,16,189,130,319,99,46,17,16,19,8,7,3,18,0,,
2439,2,143,102,245,59,42,37,14,18,9,7,1,17,0,,
2439,10,228,94,322,125,81,33,18,14,28,9,3,40,0,,
2440,8,159,133,292,74,53,32,16,16,9,8,4,21,0,,
2440,9,231,127,358,117,52,48,16,16,16,7,3,26,0,,
2441,4,231,162,393,116,38,38,12,11,16,13,3,32,0,,
2441,5,239,147,386,141,31,18,11,12,15,6,2,23,0,,
2442,18,195,131,326,108,43,35,10,14,13,7,5,25,0,,
2442,1,208,213,421,109,48,32,14,10,25,14,2,41,0,,
2443,12,223,111,334,118,76,32,16,11,17,9,0,26,0,,
2443,3,179,147,326,71,47,35,11,16,11,11,1,23,0,,
2444,15,196,145,341,105,46,22,14,13,9,4,2,15,0,,
2444,11,199,146,345,103,56,39,14,14,18,8,0,26,0,,
2445,8,177,144,321,88,45,47,18,24,9,5,2,16,0,,
2445,13,218,97,315,118,57,40,24,18,20,12,4,36,0,,
2446,2,259,98,357,181,35,20,19,13,10,8,1,19,0,,
2446,11,172,132,304,102,50,16,15,19,9,9,3,21,0,,
2447,16,185,145,330,106,42,29,12,21,13,4,2,19,0,,
2447,15,213,119,332,107,52,39,21,12,6,10,3,19,0,,
2448,5,278,149,427,177,35,27,12,12,22,12,2,36,0,,
2448,14,193,147,340,100,29,24,12,12,6,6,2,14,0,,
2449,1,158,137,295,70,64,39,20,13,14,5,1,20,0,,
2449,10,214,127,341,84,55,60,14,20,17,10,4,31,0,,
2450,18,174,101,275,89,49,27,16,11,10,11,7,28,0,,
2450,9,244,123,367,137,50,39,11,16,22,14,1,37,0,,
2451,12,213,120,333,150,36,27,11,13,4,7,3,14,0,,
2451,7,220,128,348,130,38,19,13,11,18,17,1,36,0,,
2452,3,203,96,299,112,36,21,17,23,14,7,1,22,0,,
2452,4,224,140,364,117,34,33,23,17,16,15,2,33,0,,
2453,5,249,146,395,108,48,15,19,12,21,10,3,34,0,,
2453,1,192,174,366,86,49,47,12,19,16,8,1,25,0,,
2454,14,179,156,335,94,56,26,14,17,12,14,4,30,0,,
2454,2,234,115,349,140,56,42,17,14,17,8,0,25,0,,
2455,11,224,166,390,129,48,28,13,13,18,11,4,33,0,,
2455,12,214,146,360,127,48,20,13,13,9,6,0,15,0,,
2456,3,196,101,297,109,47,23,15,16,9,13,2,24,0,,
2456,18,252,157,409,149,51,29,16,15,20,8,1,29,0,,
2457,8,209,102,311,90,34,48,19,21,7,9,3,19,0,,
2457,10,210,93,303,108,50,25,22,19,19,4,1,24,0,,
2458,9,210,132,342,112,45,42,17,12,21,14,1,36,0,,
2458,16,184,97,281,97,43,18,12,16,10,12,1,23,0,,
2459,7,220,132,352,123,25,23,14,24,10,12,2,24,0,,
2459,15,216,114,330,130,41,30,24,14,8,7,2,17,0,,
2460,4,213,130,343,96,38,33,15,11,13,15,4,32,0,,
2460,13,203,92,295,125,55,27,11,14,11,8,1,20,0,,
2461,11,236,116,352,128,61,40,18,10,30,6,1,37,0,,
2461,3,189,121,310,102,51,25,10,18,6,12,2,20,0,,
2462,14,218,125,343,112,74,33,14,22,15,8,0,23,0,,
2462,4,185,156,341,74,60,28,22,14,16,5,0,21,0,,
2463,1,207,159,366,92,53,19,13,18,16,9,4,29,0,,
2463,8,198,126,324,96,48,45,18,13,13,7,3,23,0,,
2464,5,224,117,341,119,35,30,17,19,16,11,2,29,0,,
2464,9,214,114,328,121,48,29,19,17,12,9,2,23,0,,
2465,16,205,92,297,116,68,32,17,17,15,5,5,25,0,,
2465,2,208,122,330,120,45,36,17,17,13,8,3,24,0,,
2466,15,190,71,261,93,58,31,23,18,14,10,4,28,0,,
2466,10,180,111,291,81,45,42,18,23,16,9,0,25,0,,
2467,12,212,143,355,128,41,24,22,17,12,9,3,24,0,,
2467,18,207,175,382,99,48,28,17,22,17,13,3,33,0,,
2468,13,234,129,363,131,62,35,15,11,15,11,1,27,0,,
2468,7,178,131,309,92,59,29,11,15,13,10,2,25,0,,
2469,14,218,149,367,103,54,38,16,17,20,7,3,30,0,,
2469,3,214,129,343,107,37,26,17,16,13,9,1,23,0,,
2470,2,240,138,378,131,40,19,12,15,15,9,3,27,0,,
2470,15,193,115,308,104,54,22,15,12,9,9,4,22,0,,
2471,9,205,132,337,82,71,35,17,11,8,10,2,20,0,,
2471,11,228,118,346,96,62,39,11,17,10,9,6,25,0,,
2472,10,210,72,282,67,90,39,28,22,7,4,4,15,0,,
2472,7,193,80,273,65,67,40,22,28,7,5,5,17,0,,
2473,18,232,120,352,128,58,30,19,19,22,12,1,35,0,,
2473,8,189,151,340,110,37,25,19,17,7,6,1,14,0,,
2474,1,175,162,337,83,34,29,19,20,15,7,3,25,0,,
2474,16,230,138,368,123,43,27,20,19,12,12,2,26,0,,
2475,4,209,162,371,101,51,48,19,12,16,13,2,31,0,,
2475,12,202,102,304,104,55,24,12,19,15,7,2,24,0,,
2476,13,241,136,377,132,45,41,11,19,22,7,2,31,0,,
2476,5,194,137,331,104,40,15,19,11,14,9,1,24,0,,
2477,7,187,150,337,107,58,37,14,18,8,12,0,20,0,,
2477,11,224,141,365,126,80,24,18,14,18,8,7,33,0,,
2478,16,193,130,323,103,40,36,16,13,6,16,0,22,0,,
2478,14,214,127,341,112,38,23,14,16,18,9,1,28,0,,
2479,9,182,129,311,81,49,39,16,14,14,15,3,32,0,,
2479,1,221,162,383,116,55,28,14,16,22,9,4,35,0,,
2480,18,223,129,352,105,44,28,18,10,13,10,9,32,0,,
2480,4,198,136,334,107,49,22,10,18,8,10,2,20,0,,
2481,8,234,127,361,147,50,27,24,13,16,7,2,25,0,,
2481,2,207,91,298,112,65,34,13,24,8,8,6,22,0,,
2482,3,199,164,363,108,30,21,14,16,10,11,4,25,0,,
2482,13,206,124,330,121,53,30,16,14,16,12,2,30,0,,
2483,15,220,106,326,116,42,12,22,18,18,10,3,31,0,,
2483,12,214,112,326,129,31,37,18,22,15,10,2,27,0,,
2484,10,208,132,340,114,39,35,17,12,11,15,1,27,0,,
2484,5,223,111,334,116,37,30,12,17,14,10,1,25,0,,
2485,15,204,102,306,114,53,34,12,18,14,12,0,26,0,,
2485,3,210,142,352,119,40,34,18,12,13,10,1,24,0,,
2486,13,203,119,322,103,70,34,18,15,18,10,2,30,0,,
2486,18,191,143,334,96,54,26,15,18,12,8,2,22,0,,
2487,7,220,125,345,128,63,36,13,17,18,16,1,35,0,,
2487,8,180,190,370,97,39,27,17,13,8,5,2,15,0,,
2488,9,181,135,316,84,61,29,15,16,8,19,4,31,0,,
2488,12,223,136,359,135,55,26,16,15,7,9,5,21,0,,
2489,10,178,92,270,71,62,47,21,18,12,16,3,31,0,,
2489,16,162,88,250,75,53,30,19,21,9,2,2,13,0,,
2490,11,223,166,389,128,30,22,13,13,21,19,1,41,0,,
2490,14,175,175,350,90,39,30,13,13,8,7,0,15,0,,
2491,2,255,91,346,116,69,28,17,11,13,12,2,27,0,,
2491,5,221,123,344,109,50,30,11,17,6,6,3,15,0,,
2492,4,203,152,355,103,52,33,14,14,8,7,9,24,0,,
2492,1,235,167,402,143,36,21,14,14,10,11,1,22,0,,
2493,16,222,134,356,128,35,23,18,22,19,10,1,30,0,,
2493,3,208,122,330,111,41,25,22,18,12,16,0,28,0,,
2494,12,188,137,325,88,41,26,12,12,11,9,2,22,0,,
2494,14,211,167,378,117,52,39,12,12,23,3,1,27,0,,
2495,8,194,123,317,105,43,40,23,17,16,8,0,24,0,,
2495,4,188,113,301,95,62,28,17,23,17,9,3,29,0,,
2496,13,230,141,371,125,68,40,14,9,14,9,5,28,0,,
2496,9,178,161,339,83,50,39,10,13,13,8,4,25,0,,
2497,18,195,131,326,112,53,26,20,15,6,16,2,24,0,,
2497,2,244,101,345,146,35,20,15,20,14,7,1,22,0,,
2498,10,180,91,271,100,55,35,20,19,8,13,1,22,0,,
2498,11,215,102,317,104,60,31,19,20,15,9,2,26,0,,
2499,7,208,137,345,110,42,34,18,23,19,6,2,27,0,,
2499,5,214,121,335,129,44,19,23,18,9,4,5,18,0,,
2500,1,183,158,341,93,44,25,11,21,12,8,1,21,0,,
2500,15,228,125,353,120,42,35,21,11,13,12,4,29,0,,
2501,2,202,97,299,124,25,9,16,17,7,8,2,17,0,,
2501,13,230,104,334,145,43,21,17,16,9,16,0,25,0,,
2502,3,237,160,397,84,78,26,13,9,10,8,3,21,0,,
2502,7,233,120,353,109,66,37,9,13,11,7,1,19,0,,
2503,11,218,162,380,116,54,31,17,18,16,10,2,28,0,,
2503,8,198,121,319,107,48,37,19,17,11,7,0,18,0,,
2504,15,221,146,367,138,41,28,21,11,11,15,3,29,0,,
2504,9,180,137,317,88,49,25,11,21,12,11,2,25,0,,
2505,4,195,108,303,79,64,47,35,18,9,7,6,22,0,,
2505,10,191,58,249,96,70,31,18,35,9,9,2,20,0,,
2506,14,233,124,357,128,40,24,26,17,9,8,6,23,0,,
2506,18,229,131,360,143,51,28,17,26,8,9,1,18,0,,
2507,12,216,141,357,121,39,14,20,17,11,12,2,25,0,,
2507,1,195,139,334,102,37,27,17,20,16,13,1,30,0,,
2508,5,206,131,337,90,43,21,25,16,15,12,2,29,0,,
2508,16,220,143,363,114,50,34,17,25,18,10,1,29,0,,
2509,11,191,132,323,85,38,32,15,11,19,7,3,29,0,,
2509,15,235,132,367,150,43,25,11,15,7,8,2,17,0,,
2510,5,230,109,339,114,66,34,21,16,19,12,1,32,0,,
2510,4,181,132,313,85,53,30,16,21,13,11,1,25,0,,
2511,3,208,126,334,110,52,30,13,15,16,7,2,25,0,,
2511,12,216,151,367,111,50,33,15,13,15,14,1,30,0,,
2512,9,225,139,364,113,53,42,32,18,11,13,5,29,0,,
2512,8,194,125,319,98,47,29,18,32,11,5,3,19,0,,
2513,10,200,77,277,100,66,41,17,19,14,14,3,31,0,,
2513,2,184,77,261,93,60,40,19,17,7,8,0,15,0,,
2514,7,233,129,362,147,43,24,19,14,8,10,6,24,0,,
2514,18,236,126,362,156,30,35,14,19,8,10,2,20,0,,
2515,14,243,170,413,136,67,25,12,20,13,10,2,25,0,,
2515,1,183,167,350,89,57,33,20,12,13,10,1,24,0,,
2516,16,200,157,357,105,48,40,20,17,15,5,1,21,0,,
2516,13,179,133,312,90,69,32,17,20,9,10,3,22,0,,
2517,5,240,135,375,130,63,30,24,16,16,13,4,33,0,,
2517,8,182,121,303,103,35,38,16,24,11,2,0,13,0,,
2518,7,226,158,384,129,40,23,12,17,27,11,1,39,0,,
2518,2,189,114,303,101,50,35,19,11,10,9,2,21,0,,
2519,4,208,227,435,91,59,37,19,16,26,5,4,35,0,,
2519,11,160,160,320,67,51,44,16,19,12,11,0,23,0,,
2520,3,252,140,392,140,39,25,19,14,25,6,4,35,0,,
2520,9,176,118,294,72,64,35,14,19,18,10,5,33,0,,
2521,18,171,133,304,75,53,29,24,12,7,3,5,15,0,,
2521,10,212,119,331,129,43,32,12,24,10,12,5,27,0,,
2522,15,251,117,368,152,34,19,14,12,13,9,3,25,0,,
2522,14,203,115,318,109,25,28,12,14,8,8,4,20,0,,
2523,12,209,139,348,123,51,35,10,11,13,8,3,24,0,,
2523,16,205,122,327,105,49,25,11,10,15,15,2,32,0,,
2524,13,217,180,397,109,39,28,17,14,18,8,3,29,0,,
2524,1,184,146,330,98,53,27,14,17,9,12,2,23,0,,
2525,7,199,124,323,119,54,23,16,9,8,10,1,19,0,,
2525,4,219,194,413,115,56,29,9,16,14,13,1,28,0,,
2526,12,227,127,354,132,51,29,13,18,12,5,3,20,0,,
2526,13,196,159,355,92,47,25,18,13,10,10,3,23,0,,
2527,2,225,140,365,124,46,26,12,15,10,15,3,28,0,,
2527,1,211,140,351,110,41,23,15,12,15,9,0,24,0,,
2528,10,217,96,313,97,51,51,18,19,17,10,4,31,0,,
2528,3,177,105,282,91,51,19,19,18,11,6,1,18,0,,
2529,11,228,136,364,130,57,33,10,19,7,8,8,23,0,,
2529,5,220,163,383,114,49,20,19,10,7,9,3,19,0,,
2530,9,174,128,302,77,53,33,15,14,13,7,2,22,0,,
2530,14,241,158,399,134,33,40,14,15,14,10,10,34,0,,
2531,15,214,178,392,126,52,22,17,9,12,11,1,24,0,,
2531,18,177,137,314,96,51,33,9,17,9,9,2,20,0,,
2532,16,218,152,370,126,47,33,17,12,14,16,4,34,0,,
2532,8,175,155,330,105,45,27,12,16,7,8,1,16,0,,
2533,3,247,140,387,158,40,16,12,18,10,12,2,24,0,,
2533,5,238,124,362,136,35,24,18,12,9,5,2,16,0,,
2534,13,146,104,250,71,76,25,25,20,10,3,0,13,0,,
2534,10,205,90,295,117,60,47,20,25,14,10,1,25,0,,
2535,4,194,201,395,91,57,28,13,16,14,17,6,37,0,,
2535,15,195,136,331,98,48,23,17,13,12,9,0,21,0,,
2536,2,215,139,354,119,57,38,19,15,21,14,2,37,0,,
2536,9,199,135,334,120,46,17,15,19,8,6,6,20,0,,
2537,1,203,144,347,118,44,27,18,17,13,10,3,26,0,,
2537,18,196,165,361,89,40,25,17,18,14,18,3,35,0,,
2538,11,168,141,309,85,51,30,22,16,10,14,5,29,0,,
2538,16,198,150,348,114,46,21,16,22,13,16,1,30,0,,
2539,14,200,158,358,107,48,34,15,15,11,10,4,25,0,,
2539,7,220,114,334,133,53,22,15,15,15,10,3,28,0,,
2540,8,187,166,353,110,43,26,12,21,17,9,2,28,0,,
2540,12,195,140,335,92,56,26,21,12,13,9,3,25,0,,
2541,18,228,120,348,124,33,34,16,16,12,13,2,27,0,,
2541,5,231,123,354,142,50,23,16,16,12,13,4,29,0,,
2542,14,191,105,296,88,76,45,24,16,14,5,1,20,0,,
2542,10,167,109,276,60,92,52,16,24,9,8,1,18,0,,
2543,1,202,152,354,108,48,27,19,14,16,8,1,25,0,,
2543,11,205,163,368,118,42,33,14,19,14,9,5,28,0,,
2544,3,206,136,342,99,32,26,24,22,15,12,4,31,0,,
2544,8,233,159,392,148,26,24,22,24,19,7,3,29,0,,
2545,16,244,137,381,136,30,42,15,20,17,8,4,29,0,,
2545,7,199,127,326,104,39,15,21,15,7,11,3,21,0,,
2546,9,180,114,294,92,60,26,11,22,7,9,1,17,0,,
2546,4,213,195,408,102,46,35,22,11,16,14,4,34,0,,
2547,12,222,122,344,124,36,28,12,16,14,11,0,25,0,,
2547,2,215,149,364,108,37,21,16,12,21,12,2,35,0,,
2548,15,197,124,321,101,44,25,13,11,12,9,1,22,0,,
2548,13,220,190,410,120,49,35,11,13,20,10,2,32,0,,
2549,1,186,133,319,95,52,32,22,22,13,9,3,25,0,,
2549,7,201,171,372,113,50,22,22,22,22,9,1,32,0,,
2550,14,208,158,366,109,41,29,17,20,14,7,3,24,0,,
2550,13,211,127,338,102,54,23,20,17,14,8,2,24,0,,
2551,8,223,154,377,150,35,19,7,11,7,9,7,23,0,,
2551,15,202,150,352,125,42,19,11,7,4,7,5,16,0,,
2552,2,212,109,321,130,44,27,11,16,20,9,0,29,0,,
2552,3,190,146,336,93,36,27,16,11,16,13,4,33,0,,
2553,10,196,91,287,88,66,59,17,16,14,6,7,27,0,,
2553,9,192,125,317,105,61,24,16,17,6,3,1,10,0,,
2554,18,187,116,303,87,49,29,18,10,14,8,3,25,0,,
2554,11,207,129,336,107,70,29,10,18,11,12,2,25,0,,
2555,5,228,136,364,133,50,26,20,13,24,11,1,36,0,,
2555,12,198,133,331,105,49,33,13,20,17,8,2,27,0,,
2556,4,214,140,354,106,36,19,28,18,8,10,3,21,0,,
2556,16,224,145,369,132,42,22,19,27,18,9,1,28,0,,
2557,1,209,151,360,115,49,35,15,18,22,12,2,36,0,,
2557,3,182,174,356,87,42,19,18,15,18,12,5,35,0,,
2558,2,181,153,334,108,32,21,7,17,12,10,3,25,0,,
2558,4,249,174,423,131,47,29,17,7,26,14,3,43,0,,
2559,11,202,156,358,99,69,34,16,20,23,10,3,36,0,,
2559,13,189,175,364,97,52,25,20,16,14,4,6,24,0,,
2560,9,187,153,340,104,47,26,9,15,7,13,2,22,0,,
2560,7,228,156,384,125,45,32,15,9,16,10,2,28,0,,
2561,16,237,171,408,140,38,24,18,13,23,12,1,36,0,,
2561,18,172,138,310,96,36,23,13,18,9,14,4,27,0,,
2562,10,221,151,372,116,56,37,8,14,21,7,3,31,0,,
2562,12,188,123,311,91,51,32,14,8,6,6,2,14,0,,
2563,5,245,128,373,135,40,21,11,15,20,11,8,39,0,,
2563,15,176,160,336,101,33,25,15,11,10,6,5,21,0,,
2564,8,233,172,405,139,35,25,22,20,21,6,1,28,0,,
2564,14,190,143,333,113,33,32,20,22,10,7,5,22,0,,
2565,7,188,103,291,96,58,22,23,26,10,9,3,22,0,,
2565,13,200,128,328,90,57,39,27,23,13,9,3,25,0,,
2566,11,221,145,366,121,41,23,27,16,10,12,3,25,0,,
2566,16,161,146,307,102,50,29,16,27,7,4,0,11,0,,
2567,4,189,138,327,74,61,49,25,18,12,8,4,24,0,,
2567,10,199,76,275,107,56,34,18,25,13,6,1,20,0,,
2568,5,209,131,340,118,55,24,15,17,11,11,3,25,0,,
2568,1,229,171,400,116,39,29,17,15,18,11,2,31,0,,
2569,16,212,139,351,101,52,38,20,21,14,14,4,32,0,,
2569,13,201,90,291,99,57,26,21,20,11,7,1,19,0,,
2570,4,217,203,420,101,58,30,28,12,16,13,4,33,0,,
2570,1,166,143,309,79,53,24,13,28,5,7,2,14,0,,
2571,10,200,114,314,75,52,34,12,18,19,11,2,32,0,,
2571,16,167,97,264,72,49,48,18,12,14,5,3,22,0,,
2572,11,212,98,310,128,62,30,17,18,11,9,0,20,0,,
2572,4,210,181,391,115,37,21,18,17,11,16,3,30,0,,
2573,10,168,111,279,68,69,22,21,20,12,8,4,24,0,,
2573,4,198,175,373,91,53,40,20,21,12,9,4,25,0,,
2911,13,167,145,312,80,44,23,17,28,9,5,3,17,33,42.4%,27.3%
2911,7,217,117,334,122,55,20,28,17,13,12,3,28,56,44.6%,23.2%
2912,15,165,130,295,62,40,30,19,18,10,16,3,29,54,48.1%,18.5%
2912,5,221,113,334,121,54,30,18,19,12,7,3,22,47,40.4%,25.5%
2913,16,196,157,353,99,44,37,23,27,16,7,2,25,51,45.1%,31.4%
2913,18,207,110,317,106,53,28,28,22,19,4,3,26,56,41.1%,33.9%
2914,9,204,176,380,114,35,24,25,27,9,10,5,24,53,35.8%,17.0%
2914,8,219,144,363,134,42,19,27,25,6,7,1,14,42,31.0%,14.3%
2915,10,209,97,306,108,50,41,21,29,10,11,2,23,55,38.2%,18.2%
2915,4,178,138,316,89,55,31,29,21,11,4,4,19,35,42.9%,31.4%
2916,11,164,161,325,79,41,21,19,18,10,11,3,24,49,42.9%,20.4%
2916,3,241,119,360,156,39,20,18,19,16,6,3,25,42,52.4%,38.1%
2917,1,225,194,419,106,64,22,30,28,17,9,2,28,53,49.1%,32.1%
2917,14,183,162,345,77,45,42,28,30,13,11,4,28,56,42.9%,23.2%
2918,12,192,96,288,85,54,37,27,19,15,17,8,40,60,53.3%,25.0%
2918,2,211,147,358,135,39,15,19,27,15,7,1,23,41,53.7%,36.6%
2919,9,202,121,323,99,60,30,21,14,15,8,4,27,46,50.0%,32.6%
2919,7,190,105,295,114,38,30,14,21,7,6,2,15,43,30.2%,16.3%
2920,2,139,121,260,64,59,23,17,18,11,5,1,17,36,44.4%,30.6%
2920,10,220,114,334,121,74,54,18,17,13,6,4,23,45,42.2%,28.9%
2921,14,234,185,419,136,38,44,17,15,24,18,0,42,66,63.6%,36.4%
2921,12,197,132,329,101,37,17,15,17,12,10,2,24,48,45.8%,25.0%
2922,4,222,191,413,106,58,33,28,15,12,8,7,27,51,39.2%,23.5%
2922,5,209,92,301,99,66,43,15,28,11,8,1,20,41,46.3%,26.8%
2923,18,187,168,355,94,50,35,15,18,17,14,6,37,66,47.0%,25.8%
2923,15,183,148,331,85,45,25,18,15,15,13,1,29,52,53.8%,28.8%
2924,3,228,84,312,138,44,13,23,18,19,6,2,27,53,47.2%,35.8%
2924,16,212,112,324,117,26,41,19,23,17,9,1,27,53,49.1%,32.1%
2925,1,188,165,353,113,62,26,12,12,11,6,0,17,47,36.2%,23.4%
2925,11,248,156,404,140,37,29,12,12,16,12,2,30,58,48.3%,27.6%
2926,8,188,147,335,98,51,43,21,14,17,12,2,31,52,55.8%,32.7%
2926,13,188,126,314,99,73,41,14,21,14,7,3,24,47,44.7%,29.8%
2927,5,232,131,363,118,54,29,13,14,17,8,5,30,58,43.1%,29.3%
2927,2,195,118,313,94,59,34,14,13,13,10,2,25,50,46.0%,26.0%
2928,12,175,112,287,87,60,36,13,23,18,14,3,35,57,56.1%,31.6%
2928,3,209,130,339,106,50,34,23,13,17,17,3,37,54,63.0%,31.5%
2929,18,185,144,329,100,43,36,21,11,8,12,3,23,51,39.2%,15.7%
2929,11,208,146,354,132,43,26,11,21,13,9,0,22,47,46.8%,27.7%
2930,7,218,138,356,112,40,26,18,18,17,13,1,31,54,55.6%,31.5%
2930,1,196,125,321,103,49,35,18,18,9,11,1,21,47,42.6%,19.1%
2931,16,205,91,296,105,59,32,22,23,11,4,0,15,49,30.6%,22.4%
2931,4,215,185,400,95,51,26,24,22,14,12,5,31,51,51.0%,27.5%
2932,10,185,152,337,92,63,53,14,13,13,13,5,31,52,50.0%,25.0%
2932,9,141,75,216,61,68,39,13,14,10,8,1,19,37,48.6%,27.0%
2933,13,208,149,357,111,49,26,17,12,8,6,3,17,43,32.6%,18.6%
2933,14,222,162,384,130,41,23,12,17,15,15,4,34,61,49.2%,24.6%
2934,15,181,140,321,87,63,31,21,15,10,8,2,20,48,37.5%,20.8%
2934,8,215,163,378,106,67,33,15,21,13,11,2,26,58,41.4%,22.4%
2935,2,223,161,384,113,41,26,26,19,14,13,3,30,56,48.2%,25.0%
2935,1,218,110,328,120,51,21,19,26,20,6,6,32,56,46.4%,35.7%
2936,5,216,126,342,89,77,24,16,17,9,12,0,21,47,44.7%,19.1%
2936,18,216,133,349,79,66,40,18,16,12,9,3,24,48,43.8%,25.0%
2937,7,193,145,338,102,48,33,18,15,9,12,2,23,58,36.2%,15.5%
2937,3,231,121,352,127,67,22,15,18,15,8,1,24,47,48.9%,31.9%
2938,15,214,138,352,77,71,36,20,16,12,6,9,27,52,34.6%,23.1%
2938,9,173,143,316,75,62,42,16,20,8,9,6,23,46,37.0%,17.4%
2939,11,214,98,312,122,58,29,23,20,9,5,2,16,38,36.8%,23.7%
2939,10,201,115,316,114,60,27,20,23,5,9,5,19,41,34.1%,12.2%
2940,8,206,132,338,112,47,32,16,24,10,14,2,26,50,48.0%,20.0%
2940,14,197,184,381,98,55,28,24,15,9,14,4,27,49,46.9%,18.4%
2941,13,198,163,361,91,55,24,22,15,13,9,5,27,52,42.3%,25.0%
2941,16,227,164,391,124,49,31,15,22,21,10,1,32,60,51.7%,35.0%
2942,4,241,228,469,111,55,32,17,10,14,13,3,30,55,49.1%,25.5%
2942,12,182,111,293,78,61,26,10,17,4,11,4,19,41,36.6%,9.8%
2943,3,211,126,337,102,38,18,10,20,11,11,2,24,49,44.9%,22.4%
2943,5,240,120,360,138,47,22,20,10,12,17,6,35,65,44.6%,18.5%
2944,18,257,108,365,102,85,47,21,14,14,9,3,26,59,39.0%,23.7%
2944,7,211,118,329,59,69,36,15,21,6,6,1,13,37,32.4%,16.2%
2945,2,196,118,314,121,58,18,13,29,11,6,4,21,46,37.0%,23.9%
2945,4,217,183,400,107,45,29,29,13,14,13,2,29,63,42.9%,22.2%
2946,12,187,124,311,84,46,30,24,23,18,11,5,34,55,52.7%,32.7%
2946,9,189,131,320,98,53,26,24,24,21,8,2,31,52,55.8%,40.4%
2947,10,198,127,325,81,57,57,18,20,17,3,4,24,53,37.7%,32.1%
2947,13,177,131,308,63,69,29,20,18,8,8,4,20,49,32.7%,16.3%
2948,8,220,191,411,130,42,29,26,12,13,14,1,28,54,50.0%,24.1%
2948,1,215,164,379,125,24,18,12,25,16,10,4,30,52,50.0%,30.8%
2949,14,184,158,342,81,75,43,26,23,15,7,5,27,51,43.1%,29.4%
2949,15,205,137,342,81,69,47,23,26,18,7,3,28,57,43.9%,31.6%
2950,16,223,145,368,82,73,37,21,9,7,11,5,23,51,35.3%,13.7%
2950,11,195,138,333,83,69,41,9,21,8,6,3,17,47,29.8%,17.0%
2951,7,230,109,339,140,39,28,20,19,18,15,2,35,57,57.9%,31.6%
2951,12,171,105,276,89,41,29,19,20,11,15,1,27,49,53.1%,22.4%
2952,3,222,157,379,122,46,26,21,15,15,3,3,21,46,39.1%,32.6%
2952,8,208,133,341,113,45,44,16,21,20,7,4,31,63,42.9%,31.7%
2953,4,209,196,405,95,44,24,29,15,10,14,3,27,58,41.4%,17.2%
2953,1,199,144,343,121,45,25,15,28,9,6,2,17,39,38.5%,23.1%
2954,15,192,96,288,62,54,27,21,19,16,10,5,31,57,45.6%,28.1%
2954,10,191,103,294,95,52,45,19,21,14,8,3,25,52,42.3%,26.9%
2955,11,180,141,321,90,32,23,17,24,9,5,3,17,42,33.3%,21.4%
2955,5,251,120,371,130,37,19,24,17,11,16,4,31,50,54.0%,22.0%
2956,9,212,156,368,117,42,25,20,18,17,16,2,35,64,51.6%,26.6%
2956,16,195,136,331,111,41,24,18,20,10,13,2,25,45,51.1%,22.2%
2957,13,225,146,371,128,56,28,12,16,9,13,4,26,51,43.1%,17.6%
2957,18,190,114,304,109,42,24,16,12,10,14,2,26,45,53.3%,22.2%
2958,2,168,91,259,85,51,30,21,22,9,10,1,20,47,40.4%,19.1%
2958,14,233,150,383,121,49,46,23,21,35,9,3,47,63,69.8%,55.6%
2959,15,189,171,360,86,39,30,21,21,18,5,4,27,57,40.4%,31.6%
2959,3,229,147,376,134,53,20,21,21,13,15,2,30,57,49.1%,22.8%
2960,5,217,107,324,109,61,39,24,16,17,15,2,34,59,54.2%,28.8%
2960,12,192,118,310,86,55,29,16,24,14,8,3,25,52,42.3%,26.9%
2961,18,191,139,330,103,31,34,14,9,16,16,3,35,48,66.7%,33.3%
2961,2,217,124,341,144,35,16,10,14,10,13,2,25,43,53.5%,23.3%
2962,9,174,143,317,89,55,27,24,11,9,12,3,24,52,40.4%,17.3%
2962,11,203,170,373,130,68,22,11,24,14,10,6,30,51,47.1%,27.5%
2963,7,209,85,294,124,55,35,28,15,15,5,2,22,40,50.0%,37.5%
2963,10,180,103,283,97,39,42,15,28,11,3,2,16,35,40.0%,31.4%
2964,14,220,183,403,106,59,38,20,12,16,11,2,29,61,44.3%,26.2%
2964,4,218,171,389,123,59,30,12,19,10,7,3,20,45,37.8%,22.2%
2965,1,182,135,317,70,69,40,17,16,16,14,2,32,58,51.7%,27.6%
2965,13,205,139,344,108,56,38,16,17,16,6,4,26,53,41.5%,30.2%
2966,16,204,149,353,114,40,33,24,21,14,8,4,26,45,48.9%,31.1%
2966,8,196,130,326,113,45,23,21,24,11,12,2,25,44,52.3%,25.0%
2967,11,203,143,346,106,45,41,19,17,14,10,5,29,50,48.0%,28.0%
2967,2,214,155,369,125,46,24,17,19,14,6,0,20,45,44.4%,31.1%
2968,3,234,150,384,137,44,22,16,18,18,15,4,37,58,56.9%,31.0%
2968,9,219,146,365,133,43,24,18,16,8,11,4,23,58,32.8%,13.8%
2969,14,203,177,380,76,70,28,21,18,14,6,4,24,49,40.8%,28.6%
2969,16,192,124,316,97,74,45,18,21,10,6,3,19,51,31.4%,19.6%
2970,8,236,143,379,157,34,37,12,18,10,11,1,22,41,51.2%,24.4%
2970,7,218,123,341,134,48,22,18,12,6,7,1,14,37,35.1%,16.2%
2971,15,178,138,316,60,67,52,25,24,22,12,3,37,56,60.7%,39.3%
2971,12,193,131,324,77,68,46,24,25,20,7,3,30,55,49.1%,36.4%
2972,10,203,102,305,107,50,39,23,26,17,14,2,33,46,67.4%,37.0%
2972,18,171,87,258,78,53,30,26,23,13,7,2,22,50,40.0%,26.0%
2973,1,212,147,359,91,53,36,20,14,20,9,6,35,53,54.7%,37.7%
2973,5,212,103,315,102,42,34,14,20,14,10,8,32,56,42.9%,25.0%
2974,4,187,174,361,92,38,34,18,17,19,23,0,42,55,76.4%,34.5%
2974,13,187,122,309,105,53,17,17,18,9,5,1,15,32,43.8%,28.1%
2975,16,202,169,371,114,56,28,17,26,15,9,2,26,47,51.1%,31.9%
2975,7,193,101,294,97,56,29,26,17,6,16,3,25,50,44.0%,12.0%
2976,12,203,99,302,97,50,21,24,17,12,12,2,26,54,44.4%,22.2%
2976,11,199,149,348,106,32,35,17,24,15,13,2,30,51,54.9%,29.4%
2977,8,218,136,354,147,35,30,10,19,15,9,0,24,50,48.0%,30.0%
2977,4,193,230,423,98,53,36,19,10,8,11,5,24,55,34.5%,14.5%
2978,9,170,145,315,61,49,34,26,19,13,8,1,22,54,38.9%,24.1%
2978,5,225,97,322,111,40,23,19,26,18,9,3,30,59,45.8%,30.5%
2979,2,234,109,343,150,30,9,18,17,12,9,3,24,54,38.9%,22.2%
2979,3,197,129,326,111,34,25,17,18,12,18,2,32,64,46.9%,18.8%
2980,1,153,99,252,60,50,33,21,21,8,5,4,17,40,32.5%,20.0%
2980,10,233,125,358,119,51,38,21,21,15,10,0,25,52,48.1%,28.8%
2981,13,213,156,369,126,69,45,15,26,11,7,5,23,42,42.9%,26.2%
2981,15,183,130,313,64,74,39,26,15,10,15,4,29,56,44.6%,17.9%
2982,18,217,129,346,112,42,38,24,14,8,12,0,20,37,54.1%,21.6%
2982,14,206,171,377,100,53,29,14,24,16,18,2,36,60,56.7%,26.7%
2983,5,226,98,324,103,45,25,13,15,15,9,4,28,54,44.4%,27.8%
2983,16,207,172,379,89,42,37,15,13,13,13,3,29,59,44.1%,22.0%
2984,13,228,141,369,128,65,37,16,14,13,9,2,24,52,42.3%,25.0%
2984,11,174,164,338,68,58,45,14,16,10,7,5,22,55,30.9%,18.2%
2985,4,238,187,425,136,70,41,17,10,18,9,4,31,54,50.0%,33.3%
2985,15,169,135,304,71,44,28,10,17,7,12,1,20,46,41.3%,15.2%
2986,2,192,124,316,122,56,22,17,21,10,8,5,23,44,40.9%,22.7%
2986,9,192,108,300,112,55,29,21,17,10,10,3,23,45,44.4%,22.2%
2987,10,219,139,358,107,39,40,18,22,11,5,2,18,59,27.1%,18.6%
2987,3,214,109,323,102,57,26,22,18,11,6,2,19,53,32.1%,20.8%
2988,18,210,123,333,124,35,31,19,20,10,11,4,25,44,47.7%,22.7%
2988,8,191,126,317,109,36,34,20,19,17,7,0,24,49,49.0%,34.7%
2989,12,217,163,380,115,61,37,14,20,21,8,4,33,61,47.5%,34.4%
2989,1,205,117,322,82,55,38,20,14,19,13,1,33,59,54.2%,32.2%
2990,7,200,114,314,100,60,23,25,30,9,9,2,20,52,34.6%,17.3%
2990,14,232,163,395,126,45,30,30,25,19,10,1,30,59,49.2%,32.2%
2991,3,219,134,353,120,69,23,23,25,15,4,1,20,48,39.6%,31.2%
2991,4,201,172,373,93,58,41,25,23,14,9,1,24,64,35.9%,21.9%
2992,8,172,117,289,90,56,25,25,29,9,12,0,21,48,43.8%,18.8%
2992,10,203,106,309,123,61,37,29,25,11,7,2,20,34,52.9%,32.4%
2993,9,171,161,332,74,55,24,14,15,10,8,4,22,46,39.1%,21.7%
2993,1,264,126,390,172,64,33,15,14,13,8,9,30,55,38.2%,23.6%
2994,12,222,132,354,125,56,29,24,13,22,5,4,31,53,50.9%,41.5%
2994,18,192,134,326,106,46,40,13,24,14,15,3,32,54,53.7%,25.9%
2995,11,207,167,374,127,57,31,20,19,9,5,3,17,42,33.3%,21.4%
2995,14,185,176,361,99,68,41,19,20,9,9,6,24,45,40.0%,20.0%
2996,7,195,136,331,97,52,34,15,16,8,7,3,18,51,29.4%,15.7%
2996,15,199,121,320,104,58,25,16,15,11,11,3,25,49,44.9%,22.4%
2997,16,197,132,329,113,64,39,14,25,18,11,4,33,50,58.0%,36.0%
2997,2,210,152,362,118,32,13,25,14,15,8,4,27,45,51.1%,33.3%
2998,13,214,125,339,104,46,32,24,21,13,14,2,29,52,51.9%,25.0%
2998,5,205,99,304,87,58,27,21,24,11,9,6,26,61,32.8%,18.0%
2999,12,176,117,293,96,52,22,17,16,12,6,2,20,35,51.4%,34.3%
2999,8,220,146,366,129,42,55,16,17,27,17,1,45,69,63.8%,39.1%
3000,15,181,168,349,73,57,39,14,12,7,8,4,19,50,30.0%,14.0%
3000,11,221,171,392,121,54,36,12,14,15,7,3,25,51,43.1%,29.4%
3001,1,213,129,342,116,46,18,17,19,22,8,1,31,55,54.5%,40.0%
3001,16,207,155,362,102,41,36,19,17,16,14,5,35,63,47.6%,25.4%
3002,14,225,144,369,77,113,62,20,13,12,10,3,25,61,36.1%,19.7%
3002,9,174,97,271,45,111,51,13,20,5,5,0,10,37,27.0%,13.5%
3003,18,203,141,344,110,41,40,20,19,19,11,1,31,54,55.6%,35.2%
3003,3,182,161,343,93,39,23,19,19,13,13,4,30,45,57.8%,28.9%
3004,2,226,134,360,120,52,16,24,28,18,10,6,34,61,45.9%,29.5%
3004,13,204,106,310,103,55,42,28,24,11,9,0,20,51,39.2%,21.6%
3005,10,194,130,324,96,72,48,17,16,8,5,4,17,47,27.7%,17.0%
3005,5,204,92,296,93,62,29,16,17,10,11,5,26,43,48.8%,23.3%
3006,4,208,145,353,109,50,40,19,29,11,8,2,21,46,41.3%,23.9%
3006,7,201,138,339,93,65,19,29,19,15,6,3,24,45,46.7%,33.3%
3007,3,200,114,314,101,58,36,27,18,19,7,4,30,51,51.0%,37.3%
3007,13,202,109,311,93,43,35,18,26,18,11,4,33,59,49.2%,30.5%
3008,14,203,109,312,84,73,38,32,26,13,9,0,22,50,44.0%,26.0%
3008,10,186,139,325,67,60,38,26,32,10,6,3,19,55,29.1%,18.2%
3009,16,234,155,389,146,50,37,12,20,27,11,0,38,53,71.7%,50.9%
3009,12,174,132,306,71,44,28,21,11,13,12,6,31,57,43.9%,22.8%
3010,9,204,147,351,84,49,26,28,11,15,11,4,30,59,44.1%,25.4%
3010,18,201,161,362,114,39,28,11,28,17,7,3,27,46,52.2%,37.0%
3011,7,196,151,347,108,47,33,12,12,17,12,3,32,61,47.5%,27.9%
3011,2,210,134,344,132,40,24,12,12,15,8,2,25,46,50.0%,32.6%
3012,11,210,172,382,98,48,22,16,19,10,9,5,24,55,34.5%,18.2%
3012,4,226,191,417,124,65,34,19,16,14,10,1,25,52,46.2%,26.9%
3013,15,202,148,350,108,60,35,19,16,17,8,1,26,53,47.2%,32.1%
3013,1,180,135,315,83,75,26,16,18,11,16,3,30,46,58.7%,23.9%
3014,5,231,142,373,124,34,30,19,10,12,11,4,27,49,46.9%,24.5%
3014,8,204,151,355,118,47,32,10,19,15,4,1,20,54,35.2%,27.8%
3015,3,192,142,334,105,61,35,17,17,12,6,5,23,50,36.0%,24.0%
3015,14,211,196,407,124,49,31,17,17,19,15,4,38,63,54.0%,30.2%
3016,5,223,96,319,86,72,28,22,28,12,11,6,29,46,50.0%,26.1%
3016,7,192,115,307,83,58,37,28,22,12,4,4,20,52,30.8%,23.1%
3017,1,225,155,380,123,60,23,27,13,20,8,5,33,56,50.0%,35.7%
3017,18,173,190,363,69,41,33,13,27,17,10,1,28,54,50.0%,31.5%
3018,11,206,212,418,103,64,25,21,16,15,9,3,27,58,41.4%,25.9%
3018,8,187,176,363,108,54,30,16,21,4,7,0,11,43,25.6%,9.3%
3019,4,186,200,386,91,34,35,17,13,9,9,1,19,47,38.3%,19.1%
3019,9,216,134,350,121,55,17,13,17,13,11,2,26,44,54.5%,29.5%
3020,10,201,127,328,71,67,40,16,20,11,21,2,34,58,55.2%,19.0%
3020,16,170,73,243,69,84,48,20,16,9,5,2,16,52,26.9%,17.3%
3021,12,183,135,318,82,79,19,9,17,14,10,7,31,59,40.7%,23.7%
3021,13,208,133,341,100,62,60,17,9,19,9,1,29,50,56.0%,38.0%
3022,2,196,141,337,100,45,25,14,11,11,10,3,24,46,45.7%,23.9%
3022,15,208,146,354,118,51,31,11,14,14,14,6,34,53,52.8%,26.4%
3023,7,202,153,355,112,69,37,19,13,11,12,4,27,54,42.6%,20.4%
3023,11,177,156,333,96,61,33,13,19,12,7,1,20,47,40.4%,25.5%
3024,14,216,171,387,102,58,29,16,17,11,11,3,25,52,42.3%,21.2%
3024,5,230,119,349,126,62,20,18,16,9,10,0,19,48,39.6%,18.8%
3025,18,218,178,396,109,52,22,17,17,22,18,3,43,66,60.6%,33.3%
3025,4,151,167,318,73,51,26,17,17,9,4,4,17,40,32.5%,22.5%
3026,3,212,153,365,99,65,26,17,16,14,11,3,28,57,43.9%,24.6%
3026,1,233,128,361,127,51,28,16,17,20,9,2,31,59,49.2%,33.9%
3027,13,187,147,334,107,44,29,16,22,12,10,0,22,47,46.8%,25.5%
3027,9,187,164,351,90,59,31,23,16,18,11,7,36,58,50.0%,31.0%
3028,10,208,148,356,99,44,54,14,26,25,9,3,37,65,52.3%,38.5%
3028,12,185,102,287,67,56,20,27,14,15,8,2,25,51,45.1%,29.4%
3029,8,210,167,377,118,45,35,17,9,19,11,4,34,66,45.5%,28.8%
3029,2,218,180,398,138,41,21,9,17,11,9,1,21,45,44.4%,24.4%
3030,16,182,193,375,97,53,30,11,10,11,8,4,23,53,35.8%,20.8%
3030,15,192,182,374,91,61,30,10,11,12,7,3,22,46,41.3%,26.1%
3031,14,224,198,422,132,37,29,19,18,20,14,4,38,64,53.1%,31.2%
3031,1,194,150,344,120,37,19,19,19,9,4,5,18,52,25.0%,17.3%
3032,5,215,125,340,111,61,23,15,16,18,12,2,32,51,58.8%,35.3%
3032,3,186,129,315,89,65,29,16,15,14,6,3,23,44,45.5%,31.8%
3033,11,170,161,331,74,59,48,11,11,15,8,3,26,51,45.1%,29.4%
3033,16,216,175,391,145,69,23,11,11,20,5,1,26,44,56.8%,45.5%
3034,7,223,143,366,134,52,28,21,22,14,9,2,25,43,53.5%,32.6%
3034,8,188,143,331,116,48,34,22,21,11,11,1,23,46,47.8%,23.9%
3035,4,183,175,358,72,66,49,19,15,16,14,2,32,47,63.8%,34.0%
3035,10,184,118,302,81,73,37,15,19,15,6,4,25,37,56.8%,40.5%
3036,9,205,159,364,100,51,34,20,12,25,10,3,38,70,50.0%,35.7%
3036,12,184,148,332,107,49,18,12,20,6,9,1,16,45,33.3%,13.3%
3037,2,189,183,372,96,35,19,18,21,15,5,5,25,56,35.7%,26.8%
3037,18,212,161,373,100,49,37,21,18,24,7,4,35,63,49.2%,38.1%
3038,15,202,134,336,101,48,35,18,18,19,10,2,31,49,59.2%,38.8%
3038,13,182,118,300,96,56,43,18,18,9,5,3,17,43,32.6%,20.9%
3039,1,218,127,345,110,62,26,19,14,9,12,5,26,52,40.4%,17.3%
3039,4,186,202,388,89,50,39,14,19,24,12,2,38,61,59.0%,39.3%
3040,12,229,161,390,130,47,23,21,16,15,7,4,26,55,40.0%,27.3%
3040,7,198,155,353,104,39,45,16,21,16,12,3,31,52,53.8%,30.8%
3041,16,203,154,357,107,46,21,15,12,10,11,1,22,46,45.7%,21.7%
3041,14,221,154,375,117,47,42,12,15,20,12,8,40,57,56.1%,35.1%
3042,5,196,126,322,113,45,31,17,12,7,10,4,21,44,38.6%,15.9%
3042,9,210,161,371,106,60,29,12,17,22,15,2,39,65,56.9%,33.8%
3043,10,189,115,304,99,54,36,14,16,21,10,2,33,53,58.5%,39.6%
3043,2,157,127,284,77,43,23,16,14,10,9,3,22,46,41.3%,21.7%
3044,8,191,220,411,101,46,38,12,25,10,9,2,21,49,38.8%,20.4%
3044,15,231,146,377,126,48,23,25,12,16,9,3,28,50,50.0%,32.0%
3045,3,217,149,366,105,45,37,17,12,18,7,2,27,52,48.1%,34.6%
3045,11,197,158,355,113,39,21,12,17,16,9,0,25,55,45.5%,29.1%
3046,18,241,178,419,129,51,41,14,14,25,12,1,38,60,61.7%,41.7%
3046,13,170,154,324,90,53,21,14,14,11,7,1,19,52,34.6%,21.2%
3047,1,234,128,362,155,36,21,21,18,12,8,5,25,41,48.8%,29.3%
3047,7,167,113,280,95,37,21,18,21,12,7,6,25,48,39.6%,25.0%
3048,12,208,144,352,97,55,31,29,19,14,9,3,26,47,48.9%,29.8%
3048,5,209,97,306,96,69,33,19,29,18,9,3,30,49,55.1%,36.7%
3049,14,198,230,428,95,77,46,22,18,21,8,5,34,57,50.9%,36.8%
3049,2,185,189,374,97,55,30,18,22,11,3,0,14,45,31.1%,24.4%
3050,9,188,171,359,99,85,35,16,15,10,15,2,27,59,42.4%,16.9%
3050,15,157,166,323,69,65,40,15,16,5,9,1,15,32,43.8%,15.6%
3051,11,209,143,352,86,74,41,18,18,9,10,9,28,58,32.8%,15.5%
3051,18,187,129,316,72,77,37,18,18,10,2,3,15,40,30.0%,25.0%
3052,13,180,118,298,71,55,30,29,17,9,6,4,19,41,36.6%,22.0%
3052,10,208,141,349,103,52,26,17,29,17,9,1,27,57,45.6%,29.8%
3053,8,210,178,388,116,34,20,20,22,17,14,3,34,63,49.2%,27.0%
3053,3,200,121,321,106,35,21,22,20,7,9,5,21,42,38.1%,16.7%
3054,4,183,161,344,83,45,39,20,14,14,10,3,27,51,47.1%,27.5%
3054,16,221,155,376,119,45,18,14,20,19,7,3,29,55,47.3%,34.5%
3055,2,221,164,385,116,55,21,20,17,18,7,1,26,52,48.1%,34.6%
3055,5,157,109,266,64,67,34,17,20,14,10,2,26,48,50.0%,29.2%
3056,8,218,205,423,141,45,35,19,20,17,10,3,30,57,47.4%,29.8%
3056,9,155,158,313,72,71,22,20,18,13,9,4,26,52,42.3%,25.0%
3057,18,196,189,385,97,38,29,21,18,17,12,2,31,54,53.7%,31.5%
3057,12,218,146,364,138,44,16,18,21,14,5,4,23,45,42.2%,31.1%
3058,13,201,115,316,97,64,42,25,15,19,9,6,34,56,50.0%,33.9%
3058,1,180,190,370,84,51,28,15,25,12,14,1,27,54,48.1%,22.2%
3059,10,206,111,317,119,74,36,26,27,12,8,2,22,47,42.6%,25.5%
3059,7,164,110,274,72,60,24,27,25,9,8,3,20,41,41.5%,22.0%
3060,15,176,134,310,79,61,32,19,22,15,10,2,27,51,49.0%,29.4%
3060,4,206,180,386,109,46,39,22,19,17,13,4,34,60,50.0%,28.3%
3061,14,224,176,400,126,63,32,25,20,15,10,3,28,54,46.3%,27.8%
3061,11,213,128,341,113,42,25,20,25,10,7,3,20,40,42.5%,25.0%
3062,16,219,180,399,113,33,19,20,19,21,12,2,35,62,53.2%,33.9%
3062,3,207,141,348,116,42,32,19,20,11,7,4,22,47,38.3%,23.4%
3063,5,220,101,321,112,69,30,21,31,11,13,2,26,54,44.4%,20.4%
3063,13,186,113,299,76,70,25,31,20,9,11,5,25,40,50.0%,22.5%
3064,3,239,169,408,127,41,29,11,19,18,7,3,28,62,40.3%,29.0%
3064,12,244,183,427,136,46,31,19,11,16,11,1,28,56,48.2%,28.6%
3065,7,200,111,311,113,51,35,30,29,19,12,0,31,57,54.4%,33.3%
3065,16,175,159,334,83,58,15,29,30,14,8,4,26,44,50.0%,31.8%
3066,9,160,148,308,73,43,21,21,19,9,7,2,18,40,40.0%,22.5%
3066,10,212,141,353,127,48,39,19,21,8,13,2,23,44,47.7%,18.2%
3067,4,217,117,334,130,42,40,19,20,18,8,1,27,48,54.2%,37.5%
3067,2,188,133,321,97,29,13,20,19,12,13,1,26,51,49.0%,23.5%
3068,8,160,167,327,91,60,29,20,27,12,8,2,22,42,47.6%,28.6%
3068,18,194,186,380,108,51,39,27,20,12,10,5,27,45,48.9%,26.7%
3069,15,169,136,305,77,51,29,23,18,13,8,5,26,48,43.8%,27.1%
3069,14,206,203,409,119,53,33,18,23,17,11,5,33,59,47.5%,28.8%
3070,11,206,167,373,101,46,20,24,17,15,15,2,32,55,54.5%,27.3%
3070,1,208,161,369,119,51,30,17,24,11,6,1,18,45,37.8%,24.4%
3071,7,200,113,313,91,58,29,15,15,14,11,3,28,52,48.1%,26.9%
3071,4,195,181,376,85,53,43,15,15,16,9,1,26,49,51.0%,32.7%
3072,12,190,150,340,108,44,20,19,22,11,10,3,24,46,45.7%,23.9%
3072,15,211,146,357,115,52,35,22,19,24,10,7,41,63,54.0%,38.1%
3073,16,208,164,372,114,54,15,21,22,22,11,1,34,55,60.0%,40.0%
3073,13,168,135,303,78,58,53,22,21,12,11,2,25,39,59.0%,30.8%
3074,5,223,73,296,107,67,29,28,11,15,9,2,26,59,40.7%,25.4%
3074,10,173,105,278,78,52,34,11,27,11,7,3,21,41,43.9%,26.8%
3075,11,227,218,445,112,55,33,18,22,12,13,1,26,63,39.7%,19.0%
3075,9,188,146,334,111,61,20,22,18,8,6,6,20,48,29.2%,16.7%
3076,1,192,155,347,120,42,24,17,17,10,5,2,17,38,39.5%,26.3%
3076,8,198,222,420,93,35,27,17,17,22,18,1,41,72,55.6%,30.6%
3077,14,197,155,352,104,55,39,24,19,15,9,2,26,49,49.0%,30.6%
3077,18,190,146,336,109,54,32,19,24,16,7,3,26,46,50.0%,34.8%
3078,3,189,131,320,93,39,29,25,20,13,9,5,27,55,40.0%,23.6%
3078,2,238,131,369,141,37,22,20,26,17,15,2,34,66,48.5%,25.8%
3079,5,257,100,357,159,43,20,20,18,11,9,0,20,46,43.5%,23.9%
3079,11,192,139,331,99,42,26,18,20,14,9,1,24,46,50.0%,30.4%
3080,2,197,172,369,116,49,30,14,21,13,12,2,27,45,55.6%,28.9%
3080,7,181,101,282,78,62,33,21,14,14,17,1,32,56,55.4%,25.0%
3081,4,205,176,381,93,55,34,26,22,21,5,1,27,57,45.6%,36.8%
3081,3,203,157,360,94,38,30,22,26,19,9,1,29,54,51.9%,35.2%
3082,9,177,134,311,104,53,27,15,25,15,6,7,28,52,40.4%,28.8%
3082,14,212,154,366,112,42,47,26,15,22,11,2,35,62,53.2%,35.5%
3083,18,177,148,325,92,73,40,19,18,17,13,2,32,47,63.8%,36.2%
3083,16,177,160,337,104,41,20,18,19,12,10,3,25,40,55.0%,30.0%
3084,10,203,147,350,104,67,38,19,23,22,5,4,31,53,50.9%,41.5%
3084,8,158,110,268,71,56,45,23,19,10,8,1,19,40,45.0%,25.0%
3085,1,203,137,340,110,38,26,11,22,14,8,1,23,52,42.3%,26.9%
3085,15,206,162,368,94,40,43,22,11,23,17,2,42,68,58.8%,33.8%
3086,13,228,163,391,112,37,31,9,22,21,11,2,34,68,47.1%,30.9%
3086,12,219,184,403,111,49,31,22,9,15,14,4,33,60,48.3%,25.0%
3087,18,194,140,334,97,46,25,21,15,9,12,2,23,50,42.0%,18.0%
3087,4,211,164,375,119,51,23,15,20,9,7,4,20,42,38.1%,21.4%
3088,8,184,147,331,93,54,32,20,20,15,11,4,30,61,42.6%,24.6%
3088,11,210,160,370,116,57,29,20,20,15,9,3,27,49,49.0%,30.6%
3089,5,219,102,321,102,68,33,27,16,18,11,6,35,53,54.7%,34.0%
3089,10,181,117,298,88,37,36,16,27,13,8,1,22,51,41.2%,25.5%
3090,14,220,187,407,122,63,43,34,18,23,12,6,41,65,53.8%,35.4%
3090,15,151,124,275,63,52,20,18,34,8,1,1,10,38,23.7%,21.1%
3093,14,195,175,370,77,58,37,20,23,13,12,2,27,59,42.4%,22.0%
3093,5,214,82,296,99,68,29,23,20,13,7,2,22,41,48.8%,31.7%
3094,18,227,172,399,124,55,32,14,20,20,8,5,33,59,47.5%,33.9%
3094,15,162,165,327,77,53,36,20,14,5,13,3,21,40,45.0%,12.5%
3095,14,237,180,417,126,63,33,28,25,24,16,3,43,69,58.0%,34.8%
3095,18,168,182,350,75,50,31,25,28,6,6,2,14,38,31.6%,15.8%
3448,8,192,203,395,114,63,23,24,28,11,10,1,22,47,44.7%,23.4%
3448,14,179,241,420,95,67,48,28,24,12,9,7,28,45,46.7%,26.7%
3449,3,217,154,371,99,50,26,25,13,19,9,5,33,57,49.1%,33.3%
3449,5,178,122,300,74,45,22,13,25,11,12,2,25,48,47.9%,22.9%
3450,4,203,141,344,102,56,41,29,10,15,11,2,28,51,51.0%,29.4%
3450,7,195,154,349,88,54,25,10,29,12,11,3,26,47,48.9%,25.5%
3451,2,215,174,389,133,50,31,19,13,18,7,2,27,57,43.9%,31.6%
3451,9,171,123,294,94,46,36,13,19,16,14,4,34,53,56.6%,30.2%
3452,10,193,168,361,100,58,33,23,18,6,13,4,23,51,37.3%,11.8%
3452,11,210,140,350,118,43,29,18,23,11,8,3,22,46,41.3%,23.9%
3453,18,186,175,361,89,63,31,20,21,15,5,6,26,53,37.7%,28.3%
3453,16,194,168,362,89,57,46,21,20,20,7,2,29,51,52.9%,39.2%
3454,13,196,166,362,114,32,42,15,19,10,8,2,20,37,48.6%,27.0%
3454,15,200,165,365,98,45,36,19,15,14,9,5,28,50,46.0%,28.0%
3455,1,192,122,314,103,42,29,20,20,15,6,2,23,52,40.4%,28.8%
3455,12,219,171,390,116,39,18,20,20,18,14,4,36,60,53.3%,30.0%
3456,1,221,147,368,118,37,38,17,21,23,10,3,36,53,62.3%,43.4%
3456,3,188,142,330,84,58,13,21,17,15,9,6,30,56,42.9%,26.8%
3457,2,214,149,363,130,45,19,17,24,15,12,3,30,50,54.0%,30.0%
3457,16,198,117,315,125,52,30,24,16,15,5,3,23,49,40.8%,30.6%
3458,18,199,236,435,95,46,30,14,22,18,16,5,39,55,61.8%,32.7%
3458,13,199,194,393,113,39,37,23,14,7,8,1,16,39,38.5%,17.9%
3459,9,166,127,293,69,61,37,24,18,16,8,5,29,51,47.1%,31.4%
3459,12,187,176,363,90,55,28,18,24,18,4,3,25,54,40.7%,33.3%
3460,5,213,118,331,96,61,29,19,18,18,8,2,28,51,51.0%,35.3%
3460,10,177,157,334,78,53,43,18,19,10,9,4,23,52,36.5%,19.2%
3461,14,219,205,424,115,50,49,22,18,17,8,5,30,64,39.1%,26.6%
3461,15,183,145,328,109,45,23,18,22,13,2,2,17,36,41.7%,36.1%
3462,7,234,171,405,149,65,26,18,15,13,12,5,30,44,56.8%,29.5%
3462,11,178,167,345,96,47,27,15,17,6,7,4,17,37,35.1%,16.2%
3463,4,184,212,396,84,47,52,27,12,9,5,3,17,43,32.6%,20.9%
3463,8,217,220,437,109,58,30,12,26,19,14,5,38,54,61.1%,35.2%
3464,4,199,123,322,82,42,44,29,18,10,10,4,24,44,45.5%,22.7%
3464,12,206,170,376,108,55,19,18,29,17,8,1,26,49,51.0%,34.7%
3465,14,200,205,405,106,63,38,22,24,15,13,2,30,50,56.0%,30.0%
3465,9,198,130,328,110,67,27,24,22,11,8,4,23,52,36.5%,21.2%
3466,8,210,162,372,126,40,45,23,20,24,9,1,34,49,67.3%,49.0%
3466,5,199,125,324,113,67,27,20,23,13,5,6,24,38,47.4%,34.2%
3467,11,235,159,394,101,54,46,13,15,15,13,4,32,55,50.9%,27.3%
3467,15,183,165,348,77,61,29,15,13,11,7,1,19,53,34.0%,20.8%
3468,2,206,166,372,96,42,43,23,18,16,5,6,27,54,38.9%,29.6%
3468,7,190,105,295,117,57,30,18,23,17,7,1,25,40,60.0%,42.5%
3469,10,187,175,362,93,76,47,14,10,14,10,0,24,53,45.3%,26.4%
3469,1,193,120,313,85,49,39,10,14,18,2,2,22,43,46.5%,41.9%
3470,13,189,136,325,100,61,31,21,21,17,11,6,34,49,57.1%,34.7%
3470,16,180,111,291,87,56,36,21,20,15,16,7,38,53,58.5%,28.3%
3471,3,139,166,305,60,55,22,19,17,15,3,1,19,38,47.4%,39.5%
3471,18,232,155,387,138,47,47,17,19,24,12,2,38,60,60.0%,40.0%
3472,1,243,152,395,128,53,30,23,20,19,10,1,30,50,58.0%,38.0%
3472,7,172,135,307,86,68,33,21,23,13,8,1,22,48,43.8%,27.1%
3473,15,171,125,296,83,52,38,26,23,13,7,1,21,42,47.6%,31.0%
3473,8,221,152,373,130,53,39,23,26,15,10,2,27,55,45.5%,27.3%
3474,4,207,162,369,101,41,16,22,26,10,9,4,23,51,37.3%,19.6%
3474,16,219,155,374,112,39,28,26,22,12,10,5,27,57,38.6%,21.1%
3475,9,166,85,251,78,73,40,26,21,10,6,5,21,50,32.0%,20.0%
3475,10,214,160,374,116,60,27,21,26,13,7,3,23,49,40.8%,26.5%
3476,3,184,134,318,84,66,37,26,14,23,11,1,35,51,66.7%,45.1%
3476,12,199,155,354,90,54,31,14,26,21,7,1,29,58,48.3%,36.2%
3477,14,239,195,434,128,64,34,28,20,16,12,4,32,58,48.3%,27.6%
3477,13,196,171,367,102,56,24,20,28,12,7,3,22,46,41.3%,26.1%
3478,2,182,209,391,98,36,21,11,17,11,9,3,23,57,35.1%,19.3%
3478,5,252,126,378,144,54,31,17,10,18,11,3,32,54,53.7%,33.3%
3479,11,218,149,367,132,42,23,29,25,12,8,5,25,41,48.8%,29.3%
3479,18,196,166,362,113,45,38,25,29,11,10,3,24,47,44.7%,23.4%
3480,7,219,138,357,104,69,32,19,19,18,12,3,33,56,53.6%,32.1%
3480,3,177,151,328,82,68,49,19,20,14,3,0,17,39,43.6%,35.9%
3481,14,211,148,359,100,57,37,28,25,16,14,4,34,57,52.6%,28.1%
3481,10,174,138,312,89,61,40,25,27,10,12,0,22,38,57.9%,26.3%
3482,11,205,208,413,116,42,21,14,22,12,15,1,28,41,65.9%,29.3%
3482,16,186,124,310,100,56,39,22,14,10,8,3,21,45,40.0%,22.2%
3483,9,179,132,311,93,54,37,17,7,17,10,6,33,48,56.2%,35.4%
3483,8,168,170,338,99,51,42,7,17,19,15,1,35,52,65.4%,36.5%
3484,5,223,134,357,117,29,29,12,18,15,10,5,30,63,39.7%,23.8%
3484,15,204,139,343,94,50,28,18,12,16,12,4,32,52,53.8%,30.8%
3485,13,205,166,371,113,48,34,21,18,9,8,6,23,46,37.0%,19.6%
3485,12,233,123,356,145,48,19,19,21,15,7,4,26,54,40.7%,27.8%
3486,1,186,117,303,82,46,27,20,17,19,12,4,35,54,57.4%,35.2%
3486,2,209,149,358,130,50,28,17,20,20,9,1,30,49,59.2%,40.8%
3487,4,187,153,340,86,65,34,18,12,16,6,2,24,45,48.9%,35.6%
3487,18,213,151,364,115,58,42,12,18,19,12,2,33,49,63.3%,38.8%
3488,5,187,157,344,81,44,32,21,20,8,8,6,22,42,38.1%,19.0%
3488,8,223,208,431,127,39,25,20,21,17,12,2,31,60,48.3%,28.3%
3489,3,212,147,359,100,58,20,30,18,19,3,7,29,56,39.3%,33.9%
3489,13,201,151,352,108,47,39,18,29,17,4,2,23,54,38.9%,31.5%
3490,11,210,137,347,108,50,42,28,23,13,13,3,29,55,47.3%,23.6%
3490,12,199,152,351,99,57,21,23,28,12,10,4,26,49,44.9%,24.5%
3491,14,214,194,408,116,56,45,30,18,20,9,5,34,59,49.2%,33.9%
3491,2,201,152,353,117,65,15,18,30,10,11,0,21,40,52.5%,25.0%
3492,15,178,140,318,103,47,25,16,18,13,9,5,27,45,48.9%,28.9%
3492,9,181,151,332,90,37,31,18,16,11,15,3,29,43,60.5%,25.6%
3493,1,177,150,327,77,56,27,15,27,17,9,2,28,49,53.1%,34.7%
3493,10,192,139,331,81,62,41,27,15,14,13,0,27,52,51.9%,26.9%
3494,7,201,146,347,90,71,25,18,26,14,12,5,31,61,42.6%,23.0%
3494,18,190,150,340,108,63,40,26,18,14,6,3,23,45,44.4%,31.1%
3495,16,194,177,371,84,62,25,22,22,17,11,3,31,52,53.8%,32.7%
3495,4,195,182,377,111,58,28,22,22,12,10,1,23,40,55.0%,30.0%
3496,7,200,146,346,109,41,36,21,19,14,9,1,24,52,44.2%,26.9%
3496,5,235,119,354,125,56,26,19,21,16,3,4,23,50,38.0%,32.0%
3497,8,214,194,408,120,52,28,20,16,17,11,4,32,55,50.9%,30.9%
3497,18,194,164,358,119,49,32,16,19,15,8,4,27,43,53.5%,34.9%
3498,2,216,122,338,108,59,15,24,31,10,7,2,19,39,43.6%,25.6%
3498,14,215,137,352,90,67,44,31,24,14,12,3,29,64,40.6%,21.9%
3499,12,202,187,389,118,55,29,16,18,12,13,7,32,50,50.0%,24.0%
3499,9,174,160,334,90,56,39,18,16,18,11,6,35,59,49.2%,30.5%
3500,15,198,129,327,84,74,35,15,19,13,10,1,24,51,45.1%,25.5%
3500,4,208,130,338,83,49,42,19,15,12,11,0,23,55,41.8%,21.8%
3501,11,229,159,388,121,51,31,25,11,22,12,6,40,58,58.6%,37.9%
3501,13,183,158,341,99,65,38,11,25,11,8,0,19,39,48.7%,28.2%
3502,10,180,166,346,82,73,53,24,21,21,8,9,38,53,54.7%,39.6%
3502,3,143,106,249,51,56,36,20,24,7,5,5,17,37,32.4%,18.9%
3503,16,186,190,376,100,63,43,26,18,17,8,1,26,47,53.2%,36.2%
3503,1,197,143,340,100,72,20,18,26,17,10,2,29,49,55.1%,34.7%
3504,3,215,133,348,98,76,30,18,21,16,13,4,33,60,48.3%,26.7%
3504,4,199,99,298,98,73,39,21,18,13,11,2,26,49,49.0%,26.5%
3505,16,215,139,354,128,43,30,22,26,18,10,2,30,52,53.8%,34.6%
3505,15,189,176,365,99,48,22,27,22,9,8,5,22,39,43.6%,23.1%
3506,1,252,193,445,115,76,39,17,9,19,12,5,36,67,46.3%,28.4%
3506,9,166,166,332,70,64,31,9,17,10,6,2,18,37,43.2%,27.0%
3507,11,247,154,401,157,46,35,19,12,10,10,2,22,43,46.5%,23.3%
3507,8,201,184,385,131,42,28,12,19,11,10,0,21,41,51.2%,26.8%
3508,10,217,135,352,106,63,28,18,12,14,12,6,32,54,48.1%,25.9%
3508,7,173,118,291,86,38,40,12,18,9,9,4,22,45,40.0%,20.0%
3509,14,218,227,445,113,58,23,33,23,15,15,3,33,65,46.2%,23.1%
3509,18,172,187,359,88,47,35,23,33,7,7,0,14,39,35.9%,17.9%
3510,5,202,108,310,90,68,37,15,22,12,13,4,29,54,46.3%,22.2%
3510,12,208,148,356,94,51,31,23,15,17,12,5,34,60,48.3%,28.3%
3511,2,187,130,317,105,42,35,8,18,16,15,5,36,56,55.4%,28.6%
3511,13,227,135,362,143,54,36,18,8,14,7,3,24,46,45.7%,30.4%
3512,7,226,142,368,136,53,19,16,22,10,5,0,15,36,41.7%,27.8%
3512,16,200,149,349,117,49,40,22,16,8,6,3,17,40,35.0%,20.0%
3513,8,189,212,401,110,42,35,18,20,10,13,3,26,50,46.0%,20.0%
3513,15,173,176,349,93,52,26,20,18,15,8,5,28,44,52.3%,34.1%
3514,18,153,153,306,62,47,42,18,16,19,5,4,28,53,45.3%,35.8%
3514,2,240,152,392,157,48,20,16,18,20,6,1,27,45,57.8%,44.4%
3515,4,191,145,336,92,46,23,16,8,5,12,5,22,38,44.7%,13.2%
3515,14,225,227,452,125,51,36,8,14,28,8,6,42,58,62.1%,48.3%
3516,9,183,146,329,80,47,35,21,21,11,13,4,28,61,39.3%,18.0%
3516,11,240,153,393,134,54,29,21,21,10,9,1,20,44,43.2%,22.7%
3517,13,174,119,293,98,63,40,25,16,11,6,2,19,30,56.7%,36.7%
3517,10,187,111,298,101,53,36,16,25,17,12,0,29,57,50.9%,29.8%
3518,12,174,126,300,70,67,27,18,18,15,4,7,26,55,34.5%,27.3%
3518,3,212,98,310,99,45,51,18,18,20,13,3,36,57,57.9%,35.1%
3519,5,219,138,357,116,59,28,17,14,13,10,1,24,51,45.1%,25.5%
3519,1,219,155,374,105,37,35,14,17,15,6,3,24,49,42.9%,30.6%
3520,8,213,209,422,129,48,29,16,17,18,14,4,36,55,58.2%,32.7%
3520,4,158,240,398,88,45,27,17,16,9,11,4,24,47,42.6%,19.1%
3521,2,216,159,375,118,51,33,14,14,12,12,4,28,52,46.2%,23.1%
3521,12,208,126,334,106,50,23,14,14,17,11,5,33,62,45.2%,27.4%
3522,15,181,182,363,92,47,22,22,20,9,9,6,24,47,38.3%,19.1%
3522,7,214,150,364,120,51,38,20,21,12,10,2,24,49,44.9%,24.5%
3523,1,248,169,417,132,40,22,24,20,20,12,3,35,57,56.1%,35.1%
3523,18,177,185,362,74,46,23,20,24,11,13,2,26,56,42.9%,19.6%
3524,13,215,169,384,123,66,42,22,23,14,9,0,23,44,52.3%,31.8%
3524,9,158,141,299,61,61,27,23,21,13,12,2,27,42,59.5%,31.0%
3525,16,190,144,334,88,57,59,18,14,13,9,4,26,54,40.7%,24.1%
3525,3,204,153,357,91,53,12,14,17,14,8,3,25,51,43.1%,27.5%
3526,11,191,196,387,95,58,35,16,13,8,7,1,16,47,31.9%,17.0%
3526,14,218,242,460,116,57,42,13,16,18,12,4,34,52,57.7%,34.6%
3527,10,178,131,309,95,50,36,16,20,6,14,0,20,44,45.5%,13.6%
3527,5,244,115,359,124,51,27,20,16,11,12,1,24,51,45.1%,21.6%
3528,11,211,124,335,92,69,34,18,20,9,15,5,29,53,45.3%,17.0%
3528,3,189,110,299,95,63,29,20,18,10,8,1,19,39,46.2%,25.6%
3529,5,233,158,391,117,61,21,13,18,27,6,5,38,64,51.6%,42.2%
3529,4,195,162,357,99,54,41,18,13,10,8,5,23,43,41.9%,23.3%
3530,8,184,163,347,113,38,25,20,26,12,2,0,14,35,40.0%,34.3%
3530,1,221,182,403,134,57,30,26,19,15,12,4,31,50,54.0%,30.0%
3531,9,175,158,333,71,51,34,17,16,18,18,3,39,64,56.2%,28.1%
3531,15,175,171,346,88,50,45,16,17,15,6,2,23,38,55.3%,39.5%
3532,14,194,174,368,99,80,56,23,15,19,17,2,38,66,54.5%,28.8%
3532,12,184,211,395,103,46,25,15,23,12,3,2,17,41,36.6%,29.3%
3533,10,196,143,339,77,65,52,21,24,21,9,4,34,59,50.8%,35.6%
3533,2,185,154,339,87,63,27,24,21,8,8,1,17,47,34.0%,17.0%
3534,7,219,152,371,117,68,44,22,21,19,12,3,34,55,56.4%,34.5%
3534,13,200,122,322,106,51,28,21,22,7,6,2,15,39,33.3%,17.9%
3535,16,199,146,345,103,39,34,18,20,10,12,3,25,51,43.1%,19.6%
3535,18,197,157,354,105,44,24,20,18,16,6,1,23,38,57.9%,42.1%
3536,18,184,164,348,73,46,41,22,22,10,11,4,25,45,46.7%,22.2%
3536,5,198,115,313,84,47,30,22,22,16,9,1,26,45,55.6%,35.6%
3537,3,182,200,382,91,71,28,15,18,10,8,5,23,46,39.1%,21.7%
3537,11,196,159,355,89,47,39,18,15,19,9,6,34,59,47.5%,32.2%
3538,13,227,195,422,149,62,19,8,26,11,10,3,24,55,38.2%,20.0%
3538,4,188,160,348,100,35,26,26,8,5,10,5,20,44,34.1%,11.4%
3539,9,177,141,318,83,61,29,17,15,13,9,3,25,48,45.8%,27.1%
3539,1,203,196,399,107,45,33,15,17,10,14,5,29,48,50.0%,20.8%
3540,10,178,181,359,88,57,24,14,23,14,10,0,24,48,50.0%,29.2%
3540,14,213,189,402,105,73,49,23,14,20,9,4,33,56,51.8%,35.7%
3541,2,261,173,434,179,46,23,20,17,16,6,3,25,36,61.1%,44.4%
3541,8,196,163,359,120,53,37,17,20,10,14,2,26,49,49.0%,20.4%
3542,12,178,149,327,105,29,24,23,21,14,4,2,20,42,42.9%,33.3%
3542,15,200,157,357,105,36,38,21,23,22,6,3,31,62,45.2%,35.5%
3543,16,178,170,348,100,43,34,13,9,9,11,4,24,43,46.5%,20.9%
3543,7,240,155,395,144,46,22,9,13,17,10,0,27,45,60.0%,37.8%
3544,5,254,122,376,131,85,20,22,20,20,9,5,34,56,51.8%,35.7%
3544,14,178,197,375,83,49,38,20,22,7,5,1,13,42,28.6%,16.7%
3545,12,224,144,368,114,70,26,21,15,14,8,5,27,58,37.9%,24.1%
3545,16,171,124,295,89,43,40,15,21,14,4,0,18,46,39.1%,30.4%
3546,18,209,136,345,104,58,50,24,20,14,8,2,24,50,44.0%,28.0%
3546,10,185,137,322,75,65,24,20,24,16,7,2,25,42,54.8%,38.1%
3547,4,240,174,414,123,51,27,20,16,14,13,0,27,51,52.9%,27.5%
3547,11,199,146,345,104,63,27,17,20,5,12,5,22,47,36.2%,10.6%
3548,3,151,108,259,50,55,48,27,22,10,9,3,22,39,48.7%,25.6%
3548,2,215,171,386,117,65,25,22,27,16,13,1,30,51,56.9%,31.4%
3549,9,200,157,357,92,58,33,18,13,21,11,4,36,58,55.2%,36.2%
3549,7,176,157,333,99,33,32,13,18,14,8,3,25,50,44.0%,28.0%
3550,13,196,151,347,101,67,34,23,18,12,4,2,18,42,38.1%,28.6%
3550,8,186,170,356,106,52,37,18,23,14,10,3,27,52,46.2%,26.9%
3551,1,205,150,355,114,41,27,18,13,16,9,5,30,52,48.1%,30.8%
3551,15,186,161,347,100,43,32,13,18,16,13,4,33,57,50.9%,28.1%
3552,3,220,158,378,118,56,17,25,22,14,13,1,28,56,48.2%,25.0%
3552,1,219,140,359,115,48,32,22,25,19,9,5,33,63,44.4%,30.2%
3553,7,197,174,371,94,48,33,31,24,13,11,5,29,55,43.6%,23.6%
3553,14,218,183,401,113,48,32,24,30,21,8,2,31,55,52.7%,38.2%
3554,15,200,116,316,94,55,22,25,23,18,14,5,37,66,48.5%,27.3%
3554,13,195,168,363,97,47,40,23,25,11,9,4,24,42,47.6%,26.2%
3555,18,187,207,394,95,38,50,18,19,16,5,3,24,46,45.7%,34.8%
3555,9,196,129,325,84,63,27,19,18,18,13,3,34,52,59.6%,34.6%
3556,10,212,142,354,121,54,16,25,29,16,11,0,27,50,54.0%,32.0%
3556,4,165,95,260,93,45,55,29,25,5,11,4,20,44,36.4%,11.4%
3557,8,190,200,390,114,57,26,19,30,17,10,2,29,47,57.4%,36.2%
3557,11,194,181,375,104,56,49,30,19,10,8,2,20,42,42.9%,23.8%
3558,12,257,129,386,154,51,25,18,16,17,4,5,26,48,43.8%,35.4%
3558,5,192,117,309,88,39,27,16,18,13,7,3,23,53,37.7%,24.5%
3559,16,163,112,275,84,37,26,16,24,10,10,3,23,46,43.5%,21.7%
3559,2,256,170,426,156,24,17,25,16,20,17,0,37,52,71.2%,38.5%
3560,15,184,156,340,91,51,34,19,31,17,10,2,29,48,56.2%,35.4%
3560,14,200,166,366,87,61,44,31,19,19,5,8,32,69,34.8%,27.5%
3561,2,197,189,386,126,47,16,22,26,14,9,3,26,45,51.1%,31.1%
3561,11,208,141,349,117,60,33,27,22,22,13,1,36,59,59.3%,37.3%
3562,4,204,117,321,98,42,35,21,13,11,7,5,23,52,34.6%,21.2%
3562,10,202,122,324,111,68,27,13,20,12,8,3,23,41,48.8%,29.3%
3563,3,222,115,337,140,57,27,23,21,12,3,4,19,42,35.7%,28.6%
3563,8,174,156,330,79,54,40,21,23,19,14,2,35,55,60.0%,34.5%
3564,9,201,169,370,104,54,14,16,17,14,10,2,26,55,43.6%,25.5%
3564,16,198,160,358,113,51,27,17,16,10,10,4,24,50,40.0%,20.0%
3565,7,178,138,316,96,52,26,25,13,11,9,4,24,57,35.1%,19.3%
3565,1,265,161,426,161,47,29,13,25,15,11,5,31,58,44.8%,25.9%
3566,18,212,105,317,107,73,65,16,12,8,10,5,23,41,43.9%,19.5%
3566,12,197,175,372,83,55,21,12,16,10,11,4,25,55,38.2%,18.2%
3567,13,194,170,364,90,58,42,19,14,13,11,6,30,51,47.1%,25.5%
3567,5,246,130,376,147,74,32,15,19,17,11,3,31,56,50.0%,30.4%
3568,9,187,111,298,82,52,36,28,22,13,12,6,31,44,56.8%,29.5%
3568,5,202,122,324,79,59,36,22,28,13,12,4,29,56,44.6%,23.2%
3569,13,170,135,305,99,49,29,24,23,9,8,4,21,39,43.6%,23.1%
3569,1,220,169,389,118,47,24,23,24,24,15,2,41,66,59.1%,36.4%
3570,11,225,131,356,127,52,21,20,18,21,5,2,28,50,52.0%,42.0%
3570,4,181,182,363,96,44,48,18,20,8,7,2,17,46,32.6%,17.4%
3571,16,176,162,338,95,42,40,23,29,14,8,5,27,39,56.4%,35.9%
3571,8,221,166,387,106,60,20,29,23,16,11,5,32,54,50.0%,29.6%
3572,7,206,156,362,112,39,41,22,23,19,9,2,30,53,52.8%,35.8%
3572,12,240,104,344,138,36,18,23,22,12,11,2,25,54,42.6%,22.2%
3573,10,208,138,346,109,56,26,37,32,22,13,1,36,60,58.3%,36.7%
3573,18,167,107,274,70,58,49,32,37,11,9,3,23,40,50.0%,27.5%
3574,14,236,226,462,129,31,30,22,11,22,16,2,40,65,58.5%,33.8%
3574,3,187,170,357,92,48,19,11,22,6,15,0,21,49,42.9%,12.2%
3575,2,176,135,311,99,53,31,19,24,13,8,0,21,45,46.7%,28.9%
3575,15,204,130,334,105,62,26,24,19,20,6,1,27,55,47.3%,36.4%
3576,12,210,114,324,110,33,26,27,22,11,11,2,24,48,45.8%,22.9%
3576,2,186,185,371,89,32,27,22,27,17,6,1,24,50,46.0%,34.0%
3577,18,191,153,344,104,49,46,23,25,14,7,5,26,49,42.9%,28.6%
3577,14,198,193,391,99,67,14,25,23,15,10,5,30,50,50.0%,30.0%
3578,5,222,94,316,96,55,23,20,15,16,9,6,31,49,51.0%,32.7%
3578,16,195,147,342,112,49,37,15,20,13,7,0,20,52,38.5%,25.0%
3579,4,212,214,426,96,57,35,29,17,14,5,3,22,52,36.5%,26.9%
3579,9,163,149,312,69,66,28,17,29,11,8,2,21,43,44.2%,25.6%
3580,7,202,103,305,115,43,30,33,24,6,15,0,21,45,46.7%,13.3%
3580,10,184,119,303,110,45,22,24,33,6,12,1,19,38,47.4%,15.8%
3581,1,223,170,393,131,34,22,20,21,19,9,3,31,56,50.0%,33.9%
3581,11,196,140,336,101,46,30,21,20,18,12,3,33,57,52.6%,31.6%
3582,8,213,160,373,120,55,33,20,22,23,16,0,39,54,72.2%,42.6%
3582,13,170,150,320,87,37,41,22,20,6,13,1,20,46,41.3%,13.0%
3583,15,190,114,304,101,38,29,22,15,9,12,1,22,51,41.2%,17.6%
3583,3,217,137,354,123,31,23,15,22,19,7,1,27,54,48.1%,35.2%
3584,12,201,130,331,96,50,24,23,25,12,10,5,27,45,48.9%,26.7%
3584,7,199,156,355,96,60,41,25,23,18,10,1,29,47,59.6%,38.3%
3585,5,235,131,366,115,64,34,24,22,15,11,5,31,56,46.4%,26.8%
3585,11,189,207,396,91,57,35,22,24,11,6,2,19,47,36.2%,23.4%
3586,14,234,217,451,131,77,27,24,29,18,7,3,28,58,43.1%,31.0%
3586,16,162,155,317,76,46,28,29,23,6,8,0,14,40,35.0%,15.0%
3587,3,227,167,394,108,57,23,17,19,24,6,5,35,68,44.1%,35.3%
3587,9,165,124,289,72,66,36,19,17,18,10,0,28,55,50.9%,32.7%
3588,18,182,179,361,88,66,32,16,16,10,10,4,24,43,46.5%,23.3%
3588,15,190,176,366,91,63,31,16,16,10,13,3,26,46,50.0%,21.7%
3589,8,195,88,283,80,53,29,25,29,15,15,1,31,58,51.7%,25.9%
3589,10,180,147,327,96,56,35,29,25,10,14,1,25,44,54.5%,22.7%
3590,1,216,174,390,115,69,18,15,16,14,7,4,25,56,37.5%,25.0%
3590,13,209,211,420,120,60,36,16,15,9,9,1,19,46,39.1%,19.6%
3591,4,166,146,312,90,55,49,20,14,11,6,3,20,42,40.5%,26.2%
3591,2,249,180,429,147,47,26,14,20,24,7,1,32,56,55.4%,42.9%
3592,13,196,191,387,97,62,29,19,27,5,7,4,16,44,27.3%,11.4%
3592,14,235,234,469,104,77,43,27,19,24,13,0,37,69,53.6%,34.8%
3593,12,219,185,404,124,63,21,27,10,18,16,8,42,72,47.2%,25.0%
3593,18,158,150,308,92,45,41,10,27,9,9,3,21,38,47.4%,23.7%
3594,8,197,193,390,125,63,37,20,21,16,8,6,30,48,50.0%,33.3%
3594,9,205,132,337,136,66,30,21,20,5,6,5,16,40,27.5%,12.5%
3595,5,240,115,355,115,59,43,14,16,14,11,2,27,53,47.2%,26.4%
3595,7,179,160,339,82,59,28,16,14,12,6,5,23,44,40.9%,27.3%
3596,10,181,161,342,101,58,31,18,23,17,8,2,27,55,45.5%,30.9%
3596,16,200,125,325,86,59,38,23,18,15,10,8,33,58,43.1%,25.9%
3597,15,188,151,339,104,53,30,24,14,21,8,2,31,52,55.8%,40.4%
3597,1,194,164,358,101,41,43,14,24,18,6,2,26,50,48.0%,36.0%
3598,11,205,173,378,101,68,36,26,18,16,12,0,28,47,59.6%,34.0%
3598,2,196,167,363,111,60,36,19,26,6,8,1,15,37,37.8%,16.2%
3599,4,195,168,363,89,44,44,21,20,17,9,2,28,48,54.2%,35.4%
3599,3,171,180,351,81,46,17,21,21,16,5,2,23,51,41.2%,31.4%
3600,5,241,134,375,132,51,32,18,11,23,16,0,39,67,58.2%,34.3%
3600,3,156,144,300,73,42,35,11,18,12,8,1,21,40,50.0%,30.0%
3601,16,210,168,378,109,61,48,18,25,13,9,1,23,48,45.8%,27.1%
3601,14,178,173,351,92,56,23,25,18,13,5,6,24,49,36.7%,26.5%
3602,12,205,137,342,115,62,17,17,18,11,12,3,26,45,51.1%,24.4%
3602,11,200,183,383,91,53,55,18,17,16,10,5,31,53,49.1%,30.2%
3603,18,204,149,353,112,58,41,26,22,12,8,2,22,44,45.5%,27.3%
3603,7,179,143,322,80,62,28,22,26,9,5,2,16,37,37.8%,24.3%
3604,1,248,189,437,129,46,26,18,16,20,13,1,34,61,54.1%,32.8%
3604,4,207,126,333,129,41,24,16,18,11,5,3,19,38,42.1%,28.9%
3605,9,191,160,351,84,62,33,18,18,19,19,4,42,76,50.0%,25.0%
3605,13,202,192,394,113,50,43,18,18,13,6,1,20,41,46.3%,31.7%
3606,15,166,87,253,87,44,42,17,14,9,7,3,19,50,32.0%,18.0%
3606,10,191,143,334,99,62,42,14,17,8,10,6,24,43,41.9%,18.6%
3607,8,186,184,370,101,66,32,21,25,14,20,2,36,57,59.6%,24.6%
3607,2,170,227,397,98,45,21,26,21,15,3,1,19,33,54.5%,45.5%
3608,15,189,156,345,92,46,38,20,19,17,8,4,29,51,49.0%,33.3%
3608,5,180,133,313,86,44,31,19,20,14,6,6,26,44,45.5%,31.8%
3609,14,240,223,463,127,63,39,17,23,19,9,8,36,58,48.3%,32.8%
3609,1,180,156,336,70,59,27,24,17,10,8,2,20,44,40.9%,22.7%
3610,2,211,155,366,106,49,27,25,15,16,11,1,28,64,42.2%,25.0%
3610,3,192,121,313,99,50,30,15,25,15,9,5,29,46,52.2%,32.6%
3611,9,190,137,327,100,64,12,19,24,17,9,2,28,59,44.1%,28.8%
3611,4,218,194,412,129,42,30,24,19,9,10,3,22,46,41.3%,19.6%
3612,7,228,190,418,125,52,38,28,21,18,7,4,29,46,54.3%,39.1%
3612,8,178,128,306,90,31,31,21,27,13,6,5,24,46,41.3%,28.3%
3613,12,180,142,322,75,57,34,26,22,18,11,0,29,49,59.2%,36.7%
3613,10,184,127,311,93,64,41,22,26,18,11,2,31,52,55.8%,34.6%
3614,16,187,154,341,82,64,38,23,11,16,13,5,34,66,43.9%,24.2%
3614,13,210,168,378,129,54,24,11,23,10,4,4,18,40,35.0%,25.0%
3615,18,198,146,344,71,87,45,19,24,13,11,3,27,53,45.3%,24.5%
3615,11,203,133,336,93,85,44,24,19,11,10,4,25,44,47.7%,25.0%
3616,16,221,141,362,124,46,27,23,18,12,5,3,20,49,34.7%,24.5%
3616,5,187,118,305,86,53,17,18,23,8,5,3,16,39,33.3%,20.5%
3617,15,168,163,331,71,49,24,28,13,10,11,1,22,49,42.9%,20.4%
3617,18,209,198,407,105,60,37,13,28,23,6,4,33,55,52.7%,41.8%
3618,14,234,217,451,101,66,50,31,21,24,16,4,44,66,60.6%,36.4%
3618,4,142,73,215,58,60,32,21,31,10,4,1,15,28,50.0%,35.7%
3619,11,192,148,340,61,60,37,24,20,10,13,3,26,57,40.4%,17.5%
3619,1,224,192,416,93,63,33,20,24,9,11,2,22,44,45.5%,20.5%
3620,12,169,187,356,96,45,31,28,18,12,6,3,21,43,41.9%,27.9%
3620,8,223,186,409,115,51,35,18,28,24,10,5,39,66,51.5%,36.4%
3621,10,218,151,369,130,62,44,19,29,17,9,3,29,52,50.0%,32.7%
3621,9,204,119,323,108,63,21,29,19,6,10,7,23,44,36.4%,13.6%
3622,13,205,146,351,121,37,28,19,20,6,2,3,11,34,23.5%,17.6%
3622,2,239,188,427,124,53,27,20,19,18,10,3,31,67,41.8%,26.9%
3623,3,165,142,307,91,40,22,20,18,5,6,3,14,39,28.2%,12.8%
3623,7,247,153,400,141,46,41,18,20,21,19,2,42,60,66.7%,35.0%
3624,1,218,111,329,56,41,16,0,0,13,13,4,30,0,,
3624,5,211,126,337,71,25,16,0,0,17,10,3,30,0,,
3625,8,229,106,335,100,26,23,0,0,13,12,3,28,0,,
3625,13,221,113,334,85,7,12,0,0,11,3,1,15,0,,
3626,14,194,90,284,48,20,21,0,0,20,14,2,36,0,,
3626,7,222,88,310,81,45,22,0,0,16,13,3,32,0,,
3627,12,171,117,288,68,13,15,0,0,17,9,1,27,0,,
3627,6,206,113,319,80,32,17,0,0,17,15,1,33,0,,
3628,15,194,87,281,50,20,18,0,0,24,20,2,46,0,,
3628,9,205,116,321,76,37,3,0,0,22,11,0,33,0,,
3629,4,207,97,304,63,23,44,0,0,17,16,5,38,0,,
3629,3,196,97,293,60,16,40,0,0,17,6,2,25,0,,
3630,2,206,105,311,75,29,12,0,0,12,10,2,24,0,,
3630,11,200,154,354,70,35,34,0,0,28,9,1,38,0,,
3631,2,195,103,298,51,27,23,0,0,18,13,5,36,0,,
3631,9,167,119,286,47,42,12,0,0,11,11,3,25,0,,
3632,5,204,102,306,60,48,23,0,0,17,10,1,28,0,,
3632,14,198,89,287,58,30,12,0,0,15,12,1,28,0,,
3633,7,223,145,368,81,31,19,0,0,19,15,3,37,0,,
3633,15,195,105,300,46,30,21,0,0,19,10,1,30,0,,
3634,13,207,105,312,68,15,12,0,0,13,15,2,30,0,,
3634,1,204,113,317,59,21,20,0,0,15,10,3,28,0,,
3635,3,217,110,327,72,22,8,0,0,20,9,3,32,0,,
3635,12,217,135,352,93,37,23,0,0,19,17,1,37,0,,
3636,11,189,159,348,66,32,23,0,0,15,8,3,26,0,,
3636,4,223,76,299,84,17,10,0,0,12,11,3,26,0,,
3637,10,196,102,298,68,18,12,0,0,12,16,4,32,0,,
3637,8,225,81,306,82,27,25,0,0,22,15,2,39,0,,
3638,7,229,121,350,97,34,29,0,0,20,12,0,32,0,,
3638,10,180,128,308,60,37,12,0,0,13,15,1,29,0,,
3639,6,213,135,348,70,31,7,0,0,14,10,4,28,0,,
3639,1,198,127,325,59,40,16,0,0,14,15,2,31,0,,
3640,9,184,89,273,61,27,24,0,0,17,13,0,30,0,,
3640,13,173,117,290,46,12,24,0,0,17,10,1,28,0,,
3641,4,207,108,315,72,22,46,0,0,15,15,4,34,0,,
3641,2,169,80,249,59,19,35,0,0,9,9,2,20,0,,
3642,14,175,79,254,52,28,20,0,0,13,4,2,19,0,,
3642,15,202,76,278,54,31,26,0,0,15,15,3,33,0,,
3643,12,213,94,307,62,26,24,0,0,16,11,5,32,0,,
3643,8,186,75,261,50,25,11,0,0,16,12,2,30,0,,
3644,3,205,118,323,66,22,23,0,0,16,11,2,29,0,,
3644,5,222,93,315,77,35,22,0,0,21,12,1,34,0,,
3645,11,187,132,319,60,37,28,0,0,15,10,3,28,0,,
3645,6,192,127,319,84,20,9,0,0,15,9,3,27,0,,
3646,5,188,124,312,71,37,24,0,0,15,12,2,29,0,,
3646,7,204,106,310,84,34,21,0,0,18,14,4,36,0,,
3647,15,184,103,287,56,24,24,0,0,19,13,1,33,0,,
3647,13,184,123,307,53,14,14,0,0,14,11,4,29,0,,
3648,8,202,106,308,79,35,21,0,0,11,12,1,24,0,,
3648,14,225,141,366,92,28,11,0,0,18,15,2,35,0,,
3649,10,184,114,298,62,20,9,0,0,14,10,1,25,0,,
3649,3,253,141,394,88,27,24,0,0,28,11,2,41,0,,
3650,4,204,85,289,53,32,22,0,0,14,12,2,28,0,,
3650,9,171,108,279,43,23,19,0,0,6,10,0,16,0,,
3651,2,213,131,344,68,13,17,0,0,17,17,3,37,0,,
3651,15,200,90,290,63,23,21,0,0,25,9,0,34,0,,
3652,6,211,153,364,71,60,18,0,0,24,22,1,47,0,,
3652,10,155,100,255,40,42,16,0,0,11,8,0,19,0,,
3653,1,208,91,299,63,21,23,0,0,20,5,2,27,0,,
3653,3,204,118,322,72,13,21,0,0,11,14,1,26,0,,
3654,9,189,88,277,71,37,16,0,0,19,10,2,31,0,,
3654,14,204,99,303,64,19,23,0,0,18,15,4,37,0,,
3655,7,180,114,294,61,40,17,0,0,11,10,2,23,0,,
3655,12,222,161,383,88,36,18,0,0,17,21,0,38,0,,
3656,13,195,130,325,75,17,12,0,0,10,16,1,27,0,,
3656,11,199,149,348,61,48,17,0,0,9,10,4,23,0,,
3657,13,197,151,348,69,15,20,0,0,22,18,3,43,0,,
3657,2,172,80,252,47,31,14,0,0,8,11,1,20,0,,
3658,11,181,103,284,48,35,30,0,0,12,10,6,28,0,,
3658,8,198,69,267,90,30,13,0,0,16,8,1,25,0,,
3659,15,223,99,322,71,34,19,0,0,35,17,2,54,0,,
3659,10,151,100,251,55,34,22,0,0,16,8,1,25,0,,
3660,3,220,91,311,77,27,19,0,0,23,12,6,41,0,,
3660,14,203,119,322,79,24,15,0,0,19,14,4,37,0,,
3661,12,179,102,281,52,23,21,0,0,15,11,0,26,0,,
3661,5,215,103,318,63,36,15,0,0,21,11,0,32,0,,
3662,9,217,169,386,80,29,32,0,0,17,7,1,25,0,,
3662,6,191,142,333,58,19,18,0,0,12,10,1,23,0,,
3663,4,248,98,346,76,33,17,0,0,19,11,0,30,0,,
3663,1,186,94,280,57,14,22,0,0,13,4,2,19,0,,
3664,2,218,122,340,68,34,18,0,0,19,18,4,41,0,,
3664,7,183,123,306,63,31,33,0,0,16,7,1,24,0,,
3665,1,204,106,310,79,22,20,0,0,17,5,3,25,0,,
3665,15,212,77,289,70,29,13,0,0,22,7,2,31,0,,
3666,6,163,106,269,63,42,12,0,0,12,5,2,19,0,,
3666,13,172,114,286,54,18,17,0,0,11,12,0,23,0,,
3667,8,238,118,356,103,30,17,0,0,16,16,1,33,0,,
3667,9,202,132,334,93,28,12,0,0,10,10,0,20,0,,
3668,5,210,122,332,85,44,25,0,0,14,16,1,31,0,,
3668,11,196,125,321,67,24,15,0,0,11,9,1,21,0,,
3669,14,201,103,304,76,41,23,0,0,15,13,2,30,0,,
3669,4,213,97,310,82,32,16,0,0,16,14,3,33,0,,
3670,10,209,91,300,67,23,9,0,0,13,14,3,30,0,,
3670,12,197,133,330,77,23,24,0,0,21,12,1,34,0,,
3671,4,208,89,297,94,39,32,0,0,7,13,3,23,0,,
3671,6,189,104,293,64,26,28,0,0,11,8,2,21,0,,
3672,5,194,80,274,77,45,24,0,0,14,6,4,24,0,,
3672,8,181,85,266,73,35,21,0,0,10,12,4,26,0,,
3673,12,187,120,307,57,32,21,0,0,11,9,3,23,0,,
3673,1,217,102,319,76,37,15,0,0,15,15,1,31,0,,
3674,7,216,117,333,88,33,15,0,0,9,10,3,22,0,,
3674,3,235,136,371,84,29,20,0,0,19,11,0,30,0,,
3675,14,214,125,339,80,25,22,0,0,19,11,3,33,0,,
3675,2,211,105,316,67,20,12,0,0,9,21,3,33,0,,
3676,9,226,154,380,74,36,26,0,0,33,16,5,54,0,,
3676,10,151,103,254,40,39,22,0,0,8,9,0,17,0,,
3677,11,190,164,354,65,47,25,0,0,19,8,1,28,0,,
3677,15,198,79,277,52,18,18,0,0,18,13,0,31,0,,
3678,15,212,78,290,35,30,17,0,0,20,13,1,34,0,,
3678,12,179,126,305,39,18,17,0,0,14,8,4,26,0,,
3679,8,212,111,323,82,26,27,0,0,20,9,2,31,0,,
3679,2,194,115,309,58,18,24,0,0,19,5,2,26,0,,
3680,1,225,110,335,80,36,22,0,0,22,11,0,33,0,,
3680,7,192,94,286,57,26,27,0,0,11,10,3,24,0,,
3681,6,187,81,268,39,32,11,0,0,14,7,1,22,0,,
3681,5,174,106,280,45,34,32,0,0,10,10,3,23,0,,
3682,3,255,141,396,93,35,17,0,0,16,13,2,31,0,,
3682,11,222,171,393,74,37,19,0,0,10,4,1,15,0,,
3683,13,174,138,312,60,29,27,0,0,14,14,3,31,0,,
3683,4,198,103,301,90,45,10,0,0,13,8,2,23,0,,
3684,10,163,94,257,56,28,22,0,0,15,12,2,29,0,,
3684,14,191,106,297,66,20,27,0,0,19,14,1,34,0,,
3685,3,188,117,305,68,25,31,0,0,19,12,3,34,0,,
3685,6,190,87,277,74,35,16,0,0,19,8,3,30,0,,
3686,7,186,110,296,55,29,32,0,0,9,8,2,19,0,,
3686,4,188,113,301,59,37,17,0,0,9,11,1,21,0,,
3687,2,228,120,348,77,31,14,0,0,17,15,5,37,0,,
3687,10,183,121,304,67,35,23,0,0,14,7,2,23,0,,
3688,1,182,91,273,60,25,24,0,0,9,6,2,17,0,,
3688,8,231,102,333,72,44,15,0,0,20,10,2,32,0,,
3689,5,191,117,308,73,29,24,0,0,5,11,2,18,0,,
3689,15,216,83,299,64,28,23,0,0,19,12,0,31,0,,
3690,12,222,133,355,68,34,14,0,0,17,24,2,43,0,,
3690,13,156,131,287,61,17,15,0,0,11,7,1,19,0,,
3691,9,193,117,310,74,30,21,0,0,12,12,1,25,0,,
3691,11,216,128,344,79,18,11,0,0,18,12,2,32,0,,
3692,6,194,101,295,43,43,19,0,0,7,10,4,21,0,,
3692,2,200,104,304,65,32,14,0,0,12,9,1,22,0,,
3693,14,183,110,293,50,35,18,0,0,13,7,4,24,0,,
3693,12,185,102,287,56,39,21,0,0,17,13,3,33,0,,
3694,7,210,94,304,64,28,20,0,0,20,8,2,30,0,,
3694,9,204,76,280,51,45,14,0,0,11,6,3,20,0,,
3695,10,166,98,264,49,23,15,0,0,10,3,0,13,0,,
3695,4,221,77,298,78,21,13,0,0,17,15,3,35,0,,
3696,11,206,155,361,79,36,15,0,0,15,15,2,32,0,,
3696,1,184,94,278,71,20,22,0,0,8,12,2,22,0,,
3697,8,206,98,304,69,24,13,0,0,12,14,0,26,0,,
3697,3,236,137,373,88,33,24,0,0,17,13,1,31,0,,
3698,13,215,136,351,83,25,19,0,0,24,13,3,40,0,,
3698,5,158,119,277,56,30,28,0,0,16,9,4,29,0,,
3699,4,194,95,289,57,33,20,0,0,15,8,3,26,0,,
3699,15,195,81,276,43,21,32,0,0,16,10,1,27,0,,
3700,8,237,136,373,81,31,14,0,0,23,13,1,37,0,,
3700,7,190,110,300,59,30,22,0,0,11,7,1,19,0,,
3701,1,222,120,342,80,28,17,0,0,13,15,1,29,0,,
3701,10,171,173,344,59,14,8,0,0,10,8,1,19,0,,
3702,13,201,120,321,82,19,13,0,0,15,15,0,30,0,,
3702,3,189,112,301,75,34,16,0,0,10,8,3,21,0,,
3703,12,217,123,340,84,33,15,0,0,24,9,3,36,0,,
3703,11,183,132,315,60,20,8,0,0,11,9,2,22,0,,
3704,9,189,78,267,59,18,25,0,0,14,11,2,27,0,,
3704,5,203,120,323,76,39,29,0,0,20,17,1,38,0,,
3705,14,189,110,299,47,30,25,0,0,16,15,2,33,0,,
3705,6,206,129,335,68,36,10,0,0,15,11,5,31,0,,
3706,15,196,71,267,40,21,18,0,0,11,14,0,25,0,,
3706,8,215,93,308,82,29,11,0,0,12,10,1,23,0,,
3707,6,205,135,340,67,27,18,0,0,12,4,3,19,0,,
3707,7,219,103,322,98,37,23,0,0,17,9,1,27,0,,
3708,3,229,165,394,79,30,31,0,0,21,14,1,36,0,,
3708,2,194,101,295,73,21,6,0,0,8,14,1,23,0,,
3709,5,179,88,267,57,38,27,0,0,11,4,1,16,0,,
3709,4,213,63,276,73,28,15,0,0,14,8,2,24,0,,
3710,1,226,104,330,102,33,24,0,0,17,17,2,36,0,,
3710,9,176,98,274,65,14,10,0,0,14,7,2,23,0,,
3711,11,212,183,395,72,48,32,0,0,16,16,3,35,0,,
3711,14,193,84,277,64,43,22,0,0,14,10,1,25,0,,
3712,10,181,98,279,66,37,17,0,0,23,11,0,34,0,,
3712,13,161,137,298,48,28,21,0,0,16,12,1,29,0,,
3713,10,203,96,299,76,27,12,0,0,12,10,0,22,0,,
3713,11,205,167,372,73,23,21,0,0,18,15,3,36,0,,
3714,6,208,81,289,60,34,19,0,0,18,8,3,29,0,,
3714,15,210,78,288,40,27,23,0,0,17,12,4,33,0,,
3715,7,220,119,339,59,31,13,0,0,6,8,2,16,0,,
3715,13,194,132,326,72,20,23,0,0,14,5,3,22,0,,
3716,14,223,110,333,62,21,21,0,0,15,19,1,35,0,,
3716,1,201,92,293,55,40,26,0,0,8,6,0,14,0,,
3717,3,238,138,376,71,26,19,0,0,23,12,5,40,0,,
3717,9,195,87,282,51,31,19,0,0,4,14,1,19,0,,
3718,2,192,116,308,74,20,16,0,0,17,11,4,32,0,,
3718,5,202,139,341,75,44,25,0,0,22,12,3,37,0,,
3719,4,212,86,298,83,31,19,0,0,13,11,2,26,0,,
3719,12,194,122,316,71,25,33,0,0,14,7,1,22,0,,
3720,15,211,85,296,71,26,15,0,0,19,12,3,34,0,,
3720,3,245,130,375,101,30,23,0,0,13,11,2,26,0,,
3721,5,222,121,343,74,46,32,0,0,25,16,3,44,0,,
3721,10,170,109,279,55,19,4,0,0,11,8,3,22,0,,
3722,13,210,128,338,72,17,24,0,0,22,7,2,31,0,,
3722,14,174,99,273,45,33,16,0,0,20,5,2,27,0,,
3723,8,223,146,369,97,36,16,0,0,15,18,2,35,0,,
3723,6,192,93,285,63,26,13,0,0,9,7,3,19,0,,
3724,12,232,142,374,91,25,14,0,0,19,14,3,36,0,,
3724,9,225,99,324,79,38,15,0,0,14,11,2,27,0,,
3725,11,218,179,397,76,40,35,0,0,23,14,4,41,0,,
3725,7,199,104,303,65,27,25,0,0,8,14,1,23,0,,
3726,2,196,121,317,76,28,9,0,0,8,10,4,22,0,,
3726,1,202,119,321,68,36,32,0,0,10,15,3,28,0,,
3727,11,267,164,431,87,31,24,0,0,26,10,5,41,0,,
3727,2,206,101,307,59,36,27,0,0,4,6,2,12,0,,
3728,5,212,136,348,79,43,14,0,0,21,16,3,40,0,,
3728,1,191,105,296,66,27,17,0,0,11,13,2,26,0,,
3729,13,190,127,317,78,23,21,0,0,12,14,4,30,0,,
3729,8,202,102,304,82,47,20,0,0,16,8,2,26,0,,
3730,7,214,139,353,87,32,26,0,0,27,14,1,42,0,,
3730,14,167,109,276,51,26,19,0,0,15,15,1,31,0,,
3731,6,197,103,300,75,38,8,0,0,14,9,2,25,0,,
3731,12,222,139,361,83,32,15,0,0,27,18,1,46,0,,
3732,3,197,127,324,72,35,19,0,0,12,15,2,29,0,,
3732,4,178,101,279,68,29,11,0,0,13,9,0,22,0,,
3733,9,247,125,372,79,38,20,0,0,15,12,2,29,0,,
3733,15,226,107,333,73,20,29,0,0,22,13,1,36,0,,
3734,15,180,91,271,53,24,24,0,0,14,11,2,27,0,,
3734,7,227,122,349,86,37,16,0,0,16,12,4,32,0,,
3735,1,193,149,342,73,36,28,0,0,14,13,0,27,0,,
3735,13,195,146,341,64,21,16,0,0,16,11,3,30,0,,
3736,12,215,105,320,90,28,23,0,0,12,11,0,23,0,,
3736,3,218,104,322,83,35,12,0,0,15,14,0,29,0,,
3737,14,205,117,322,80,22,14,0,0,13,5,4,22,0,,
3737,5,190,110,300,71,30,19,0,0,11,11,2,24,0,,
3738,8,239,122,361,118,37,13,0,0,24,14,1,39,0,,
3738,10,180,87,267,60,26,13,0,0,9,11,2,22,0,,
3739,9,188,108,296,65,29,21,0,0,18,8,2,28,0,,
3739,2,201,100,301,70,20,16,0,0,14,12,3,29,0,,
3740,4,209,108,317,75,35,29,0,0,15,16,1,32,0,,
3740,11,178,91,269,55,23,28,0,0,10,9,1,20,0,,
3741,5,163,68,231,40,29,18,0,0,7,10,3,20,0,,
3741,3,217,115,332,47,27,24,0,0,18,12,3,33,0,,
3742,2,169,101,270,45,16,19,0,0,11,14,1,26,0,,
3742,4,182,99,281,70,39,16,0,0,15,8,2,25,0,,
3743,15,195,97,292,47,29,22,0,0,10,10,2,22,0,,
3743,14,240,166,406,110,19,14,0,0,25,13,3,41,0,,
3744,1,225,136,361,98,28,29,0,0,22,13,1,36,0,,
3744,6,193,110,303,79,46,10,0,0,13,5,1,19,0,,
3745,8,194,93,287,82,38,10,0,0,13,7,6,26,0,,
3745,12,198,142,340,72,26,19,0,0,17,18,2,37,0,,
3746,10,170,105,275,67,27,21,0,0,17,15,1,33,0,,
3746,7,178,105,283,67,35,24,0,0,24,9,2,35,0,,
3747,13,229,171,400,81,30,15,0,0,20,17,1,38,0,,
3747,9,176,110,286,60,20,15,0,0,6,13,0,19,0,,
3748,3,192,138,330,59,25,25,0,0,18,8,1,27,0,,
3748,10,195,102,297,71,37,15,0,0,13,17,1,31,0,,
3749,14,204,151,355,70,20,26,0,0,22,16,2,40,0,,
3749,8,164,83,247,48,37,11,0,0,10,6,2,18,0,,
3750,7,195,119,314,71,32,16,0,0,9,13,1,23,0,,
3750,5,193,112,305,63,40,26,0,0,10,16,4,30,0,,
3751,2,213,114,327,60,23,10,0,0,12,8,3,23,0,,
3751,12,190,110,300,58,27,16,0,0,16,9,1,26,0,,
3752,6,209,175,384,80,39,14,0,0,15,9,0,24,0,,
3752,11,178,130,308,60,35,13,0,0,13,14,2,29,0,,
3753,9,192,83,275,53,26,19,0,0,10,10,1,21,0,,
3753,4,226,91,317,78,16,9,0,0,19,13,4,36,0,,
3754,10,167,89,256,56,29,25,0,0,15,8,1,24,0,,
3754,6,183,94,277,67,29,14,0,0,17,12,0,29,0,,
3755,3,215,141,356,82,25,29,0,0,14,13,1,28,0,,
3755,1,211,103,314,50,42,20,0,0,12,12,1,25,0,,
3756,12,187,111,298,40,43,22,0,0,10,14,3,27,0,,
3756,7,206,106,312,52,34,17,0,0,11,15,3,29,0,,
3757,15,198,89,287,53,28,23,0,0,19,12,2,33,0,,
3757,2,202,135,337,66,20,10,0,0,11,16,2,29,0,,
3758,11,221,138,359,75,38,23,0,0,13,22,5,40,0,,
3758,13,198,93,291,77,26,14,0,0,6,10,0,16,0,,
3759,4,214,48,262,50,19,20,0,0,10,6,1,17,0,,
3759,8,215,71,286,50,21,29,0,0,6,3,6,15,0,,
3760,1,218,86,304,62,52,32,0,0,14,9,1,24,0,,
3760,4,184,69,253,48,34,16,0,0,7,10,0,17,0,,
3761,14,209,123,332,71,28,19,0,0,19,11,1,31,0,,
3761,3,208,122,330,66,25,19,0,0,14,8,2,24,0,,
3762,5,186,76,262,53,40,12,0,0,8,10,5,23,0,,
3762,12,205,127,332,60,33,22,0,0,17,13,2,32,0,,
3763,6,252,136,388,104,32,10,0,0,22,12,3,37,0,,
3763,9,194,97,291,71,21,21,0,0,5,12,1,18,0,,
3764,8,236,76,312,101,34,12,0,0,17,11,2,30,0,,
3764,11,198,132,330,69,26,22,0,0,13,10,0,23,0,,
3765,10,188,94,282,71,19,36,0,0,14,12,2,28,0,,
3765,15,179,85,264,45,34,20,0,0,25,6,4,35,0,,
3766,2,149,84,233,50,23,15,0,0,8,4,2,14,0,,
3766,13,231,149,380,93,32,15,0,0,26,17,2,45,0,,
3767,4,181,70,251,43,43,19,0,0,14,10,2,26,0,,
3767,14,201,133,334,70,28,45,0,0,17,12,2,31,0,,
3768,12,191,112,303,64,41,25,0,0,16,13,2,31,0,,
3768,10,184,113,297,48,37,19,0,0,16,13,1,30,0,,
3769,7,211,128,339,83,32,26,0,0,18,14,3,35,0,,
3769,2,183,107,290,65,28,10,0,0,12,7,3,22,0,,
3770,15,182,91,273,58,29,19,0,0,18,11,4,33,0,,
3770,1,215,128,343,81,34,17,0,0,20,13,2,35,0,,
3771,9,185,130,315,59,29,19,0,0,15,14,2,31,0,,
3771,8,206,119,325,91,27,11,0,0,24,18,1,43,0,,
3772,11,219,125,344,69,42,30,0,0,19,18,3,40,0,,
3772,5,189,96,285,87,22,24,0,0,17,9,0,26,0,,
3773,13,182,119,301,77,20,17,0,0,11,8,1,20,0,,
3773,6,222,131,353,100,39,12,0,0,14,11,3,28,0,,
3774,4,240,121,361,83,43,16,0,0,17,16,2,35,0,,
3774,15,188,91,279,40,34,29,0,0,11,2,1,14,0,,
3775,12,201,109,310,79,24,24,0,0,15,7,3,25,0,,
3775,3,211,123,334,71,27,18,0,0,14,12,2,28,0,,
3776,11,206,154,360,60,30,23,0,0,16,13,1,30,0,,
3776,8,231,94,325,114,27,14,0,0,13,14,3,30,0,,
3777,12,209,111,320,90,27,21,0,0,13,8,0,21,0,,
3777,11,196,134,330,58,17,17,0,0,8,10,10,28,0,,
3778,3,197,130,327,67,27,26,0,0,16,9,3,28,0,,
3778,4,195,98,293,68,36,24,0,0,11,6,4,21,0,,
3779,3,188,120,308,62,36,31,0,0,17,7,2,26,0,,
3779,11,190,125,315,64,40,16,0,0,14,14,2,30,0,,
3780,3,217,134,351,90,34,13,0,0,20,11,2,33,0,,
3780,12,175,110,285,61,20,14,0,0,13,8,3,24,0,,
3781,9,192,79,271,71,32,13,21,21,10,6,2,18,0,,
3781,12,185,78,263,45,17,24,21,21,13,12,2,27,0,,
3782,8,193,62,255,67,32,14,25,19,21,14,1,36,0,,
3782,14,172,116,288,56,19,23,19,25,18,12,1,31,0,,
3783,11,190,131,321,53,21,13,31,24,12,12,3,27,0,,
3783,1,216,79,295,89,22,19,24,31,17,11,1,29,0,,
3784,7,206,139,345,82,32,17,20,21,18,19,1,38,0,,
3784,3,202,91,293,83,27,22,21,20,17,7,2,26,0,,
3785,12,165,97,262,54,14,11,23,23,17,10,3,30,0,,
3785,8,178,89,267,48,24,15,23,23,12,13,4,29,0,,
3786,2,177,136,313,53,19,16,22,12,9,9,2,20,0,,
3786,15,241,117,358,83,13,8,12,22,19,16,1,36,0,,
3787,13,178,87,265,52,7,25,19,19,17,7,4,28,0,,
3787,14,192,130,322,64,18,15,20,19,15,11,4,30,0,,
3788,5,218,153,371,89,28,21,22,20,23,13,3,39,0,,
3788,9,167,133,300,52,30,16,20,22,13,8,2,23,0,,
3789,10,198,128,326,66,33,28,19,32,14,11,3,28,0,,
3789,4,207,114,321,62,33,13,34,18,14,11,0,25,0,,
3790,1,191,114,305,68,31,19,24,26,16,9,3,28,0,,
3790,7,204,123,327,66,25,23,26,24,9,17,5,31,0,,
3791,3,186,99,285,68,19,26,19,33,15,5,3,23,0,,
3791,6,235,130,365,91,31,10,33,19,22,14,4,40,0,,
3792,5,198,81,279,72,33,25,27,20,17,11,3,31,0,,
3792,10,193,115,308,49,38,20,20,27,13,19,0,32,0,,
3793,15,209,90,299,71,16,14,30,29,10,15,0,25,0,,
3793,8,232,94,326,92,21,17,29,30,14,16,1,31,0,,
3794,13,211,97,308,86,34,14,25,19,13,14,3,30,0,,
3794,11,196,141,337,62,16,16,19,25,15,14,0,29,0,,
3795,14,220,101,321,76,27,25,16,24,29,20,4,53,0,,
3795,2,158,109,267,49,23,7,24,16,11,5,1,17,0,,
3796,9,187,121,308,65,21,24,21,25,11,14,2,27,0,,
3796,6,172,95,267,43,21,14,25,21,8,6,4,18,0,,
3797,4,205,119,324,65,27,31,30,29,16,14,3,33,0,,
3797,7,175,112,287,61,21,35,29,30,12,7,1,20,0,,
3798,1,214,89,303,63,35,25,19,24,9,11,4,24,0,,
3798,3,230,97,327,76,36,12,24,19,13,8,5,26,0,,
3799,15,205,94,299,56,39,15,18,24,16,11,3,30,0,,
3799,12,200,102,302,62,16,15,24,18,19,9,2,30,0,,
3800,2,207,145,352,72,17,11,23,20,17,15,2,34,0,,
3800,13,192,79,271,66,21,34,20,23,9,14,1,24,0,,
3801,7,192,88,280,84,27,18,36,31,16,11,1,28,0,,
3801,8,191,104,295,77,15,19,31,36,14,13,1,28,0,,
3802,3,216,124,340,62,21,22,25,19,17,11,2,30,0,,
3802,5,223,103,326,81,29,17,19,25,19,9,1,29,0,,
3803,6,237,151,388,87,25,19,17,18,19,10,6,35,0,,
3803,11,177,133,310,65,26,21,18,17,14,12,1,27,0,,
3804,4,182,97,279,50,21,33,29,20,15,13,4,32,0,,
3804,14,174,85,259,55,20,39,20,30,20,8,3,31,0,,
3805,10,202,132,334,64,25,21,9,24,17,17,0,34,0,,
3805,1,218,108,326,80,27,17,24,9,25,13,2,40,0,,
3806,12,166,82,248,70,12,16,35,22,10,11,2,23,0,,
3806,10,192,115,307,63,33,19,22,35,14,9,1,24,0,,
3807,9,194,101,295,82,26,18,24,19,14,7,1,22,0,,
3807,4,198,108,306,50,22,22,19,24,13,13,1,27,0,,
3808,15,201,116,317,56,32,19,25,19,14,14,3,31,0,,
3808,1,218,124,342,72,20,23,19,25,20,17,3,40,0,,
3809,8,194,93,287,59,36,16,21,25,16,16,2,34,0,,
3809,3,201,123,324,76,31,25,25,21,22,9,0,31,0,,
3810,11,201,113,314,71,18,23,18,20,23,12,1,36,0,,
3810,2,208,127,335,72,28,24,20,18,17,13,2,32,0,,
3811,6,182,115,297,62,30,10,26,29,16,11,1,28,0,,
3811,7,217,132,349,77,31,27,29,26,17,24,2,43,0,,
3812,13,222,102,324,88,25,19,14,25,14,12,2,28,0,,
3812,5,230,140,370,86,35,21,25,14,19,13,4,36,0,,
3813,10,170,86,256,63,33,19,17,17,11,9,1,21,0,,
3813,15,192,81,273,62,24,18,17,17,18,12,5,35,0,,
3814,3,221,114,335,79,30,15,20,20,18,12,4,34,0,,
3814,13,225,90,315,80,29,24,20,20,19,6,3,28,0,,
3815,5,200,104,304,82,26,20,20,30,17,9,0,26,0,,
3815,8,235,92,327,95,32,33,30,20,20,15,0,35,0,,
3816,12,167,90,257,45,16,29,26,26,18,9,4,31,0,,
3816,7,188,118,306,65,45,11,26,26,17,10,1,28,0,,
3817,2,196,109,305,72,21,9,26,23,14,12,0,26,0,,
3817,4,188,86,274,56,36,16,23,26,14,11,2,27,0,,
3818,11,208,157,365,61,26,39,22,32,19,15,5,39,0,,
3818,9,201,113,314,71,24,35,32,22,11,7,1,19,0,,
3819,14,230,111,341,82,29,20,19,26,25,23,2,50,0,,
3819,6,170,130,300,47,30,9,26,19,11,10,1,22,0,,
3820,13,206,83,289,79,27,30,28,17,13,11,7,31,0,,
3820,10,191,153,344,73,28,18,17,28,13,14,4,31,0,,
3821,8,242,106,348,123,18,24,24,26,25,17,5,47,0,,
3821,2,188,118,306,55,14,11,21,24,14,9,0,23,0,,
3822,5,224,136,360,98,38,23,22,33,16,18,2,36,0,,
3822,15,187,91,278,48,16,22,33,22,9,11,1,21,0,,
3823,7,210,159,369,95,32,31,34,26,21,12,1,34,0,,
3823,11,172,106,278,48,30,17,25,34,9,10,1,20,0,,
3824,6,189,112,301,64,31,39,19,26,15,11,1,27,0,,
3824,4,206,78,284,58,21,25,26,19,11,13,3,27,0,,
3825,9,198,118,316,89,22,12,12,15,11,8,1,20,0,,
3825,14,254,104,358,101,24,32,16,12,37,16,1,54,0,,
3826,1,229,109,338,86,23,20,32,24,18,20,0,38,0,,
3826,12,176,85,261,73,21,17,24,32,11,6,0,17,0,,
3827,5,233,119,352,101,26,16,24,29,9,18,0,27,0,,
3827,12,233,107,340,87,22,13,29,24,16,7,2,25,0,,
3828,10,214,133,347,57,22,26,26,19,19,18,3,40,0,,
3828,9,187,102,289,78,18,7,19,26,8,12,1,21,0,,
3829,7,231,161,392,88,27,24,22,18,18,16,1,35,0,,
3829,13,215,100,315,84,23,23,18,22,10,4,1,15,0,,
3830,2,182,93,275,60,21,12,20,24,15,8,4,27,0,,
3830,6,225,134,359,75,28,12,24,20,24,15,2,41,0,,
3831,15,232,107,339,87,32,34,12,18,19,15,3,37,0,,
3831,3,210,114,324,78,22,17,18,12,11,14,0,25,0,,
3832,14,225,102,327,94,28,18,21,27,32,17,1,50,0,,
3832,11,178,129,307,39,37,35,27,21,12,14,1,27,0,,
3833,4,243,115,358,89,24,17,19,27,19,17,2,38,0,,
3833,1,200,100,300,74,27,41,27,19,11,6,2,19,0,,
3834,15,194,83,277,41,24,28,24,19,9,12,0,21,0,,
3834,6,206,78,284,57,39,13,19,24,15,13,2,30,0,,
3835,8,213,128,341,82,28,16,30,26,18,12,0,30,0,,
3835,13,201,102,303,75,28,28,26,30,7,5,1,13,0,,
3836,3,224,127,351,71,23,19,33,26,17,20,2,39,0,,
3836,14,212,94,306,60,22,12,27,33,28,12,1,41,0,,
3837,12,195,100,295,59,18,29,29,22,11,13,3,27,0,,
3837,4,196,71,267,56,39,15,22,29,15,13,3,31,0,,
3838,2,208,134,342,70,11,16,17,16,19,16,4,39,0,,
3838,10,182,97,279,60,26,12,16,17,14,18,0,32,0,,
3839,9,233,82,315,79,19,7,33,22,6,5,1,12,0,,
3839,1,223,96,319,46,33,25,22,33,11,15,3,29,0,,
3840,11,222,135,357,68,21,28,20,25,9,7,3,19,0,,
3840,5,209,84,293,72,21,27,25,20,9,11,4,24,0,,
3841,4,234,104,338,52,39,31,13,22,17,10,6,33,0,,
3841,11,218,125,343,68,18,34,22,13,11,9,3,23,0,,
3842,13,228,149,377,90,31,26,21,27,21,11,3,35,0,,
3842,15,177,119,296,56,24,14,27,21,16,8,0,24,0,,
3843,1,224,107,331,88,22,24,25,21,16,8,3,27,0,,
3843,2,232,120,352,81,31,11,21,25,13,11,1,25,0,,
3844,12,227,93,320,79,28,15,31,26,18,6,2,26,0,,
3844,3,201,121,322,56,40,13,26,31,7,19,3,29,0,,
3845,14,185,71,256,51,28,15,17,32,9,10,2,21,0,,
3845,5,228,66,294,78,43,31,32,17,12,9,0,21,0,,
3846,7,229,172,401,91,24,24,27,23,25,16,2,43,0,,
3846,9,210,104,314,77,29,5,23,27,9,4,2,15,0,,
3847,10,182,112,294,59,23,13,20,24,12,13,0,25,0,,
3847,8,223,116,339,63,24,29,24,20,21,17,3,41,0,,
3848,14,200,96,296,43,26,36,21,21,19,12,3,34,0,,
3848,7,197,134,331,66,38,16,21,21,18,16,2,36,0,,
3849,6,164,97,261,52,46,17,23,23,13,10,4,27,0,,
3849,5,181,82,263,63,29,27,23,23,13,9,2,24,0,,
3850,13,193,89,282,77,26,23,16,21,10,4,1,15,0,,
3850,12,198,135,333,77,29,15,21,16,14,12,3,29,0,,
3851,2,216,150,366,82,12,19,24,27,22,8,2,32,0,,
3851,9,208,113,321,75,26,15,27,24,11,13,4,28,0,,
3852,1,220,136,356,80,27,23,26,21,16,13,0,29,0,,
3852,8,204,113,317,58,19,13,19,25,11,7,2,20,0,,
3853,3,224,145,369,82,42,17,28,14,16,16,4,36,0,,
3853,10,195,112,307,68,43,18,14,28,10,10,3,23,0,,
3854,11,206,148,354,84,24,20,13,15,21,11,5,37,0,,
3854,15,195,151,346,87,15,12,15,13,16,9,2,27,0,,
3855,15,192,61,253,45,17,24,32,24,10,6,0,16,0,,
3855,4,223,91,314,34,38,10,24,32,14,15,11,40,0,,
3856,6,211,149,360,76,36,9,24,27,11,11,7,29,0,,
3856,1,221,140,361,92,29,23,27,24,22,11,3,36,0,,
3857,3,210,121,331,73,19,22,25,28,19,15,1,35,0,,
3857,2,201,91,292,67,18,12,28,25,11,10,3,24,0,,
3858,12,200,86,286,46,40,20,25,15,13,10,2,25,0,,
3858,14,219,74,293,57,24,23,15,25,16,21,1,38,0,,
3859,9,241,132,373,110,36,24,14,21,16,6,1,23,0,,
3859,13,230,121,351,92,30,13,21,14,11,9,2,22,0,,
3860,5,203,102,305,84,36,15,29,23,11,8,2,21,0,,
3860,7,215,145,360,82,30,20,25,28,10,12,5,27,0,,
3861,8,229,92,321,92,29,16,25,25,15,11,1,27,0,,
3861,11,210,131,341,73,22,16,25,25,15,8,5,28,0,,
3862,7,201,160,361,100,25,14,13,10,24,11,2,37,0,,
3862,10,157,108,265,34,23,24,10,16,15,13,1,29,0,,
3863,15,217,112,329,77,24,19,20,18,17,12,1,30,0,,
3863,14,225,109,334,87,40,27,18,20,29,16,2,47,0,,
3864,8,226,142,368,103,23,23,21,24,22,11,2,35,0,,
3864,6,183,130,313,76,24,15,24,21,13,9,2,24,0,,
3865,12,207,104,311,67,21,16,30,28,17,9,4,30,0,,
3865,11,216,160,376,79,32,25,28,30,13,11,3,27,0,,
3866,1,245,126,371,96,30,20,32,17,25,9,2,36,0,,
3866,13,189,140,329,62,22,25,17,32,8,4,2,14,0,,
3867,9,213,117,330,102,20,24,14,26,12,12,1,25,0,,
3867,3,197,102,299,71,34,23,27,13,18,11,0,29,0,,
3868,4,198,84,282,52,23,24,25,24,8,10,4,22,0,,
3868,5,195,79,274,55,24,55,19,25,8,11,4,23,0,,
3869,15,230,126,356,72,16,18,26,23,20,14,3,37,0,,
3869,9,224,118,342,86,43,8,23,26,16,5,1,22,0,,
3870,2,171,132,303,49,22,27,10,21,15,14,4,33,0,,
3870,7,203,178,381,79,32,22,21,10,24,12,1,37,0,,
3871,8,187,113,300,52,43,18,19,26,8,12,0,20,0,,
3871,4,202,108,310,58,40,14,26,19,11,4,4,19,0,,
3872,6,184,114,298,51,33,10,30,30,20,11,2,33,0,,
3872,12,155,100,255,51,21,24,30,30,17,11,1,29,0,,
3873,5,213,109,322,87,39,13,33,17,11,15,1,27,0,,
3873,1,207,93,300,72,29,24,17,33,11,6,4,21,0,,
3874,11,196,140,336,77,24,21,29,21,14,7,1,22,0,,
3874,3,197,83,280,66,13,11,21,29,21,8,2,31,0,,
3875,10,176,83,259,55,39,25,24,21,11,16,1,28,0,,
3875,14,211,64,275,73,23,18,21,24,24,11,3,38,0,,
3876,11,207,131,338,68,14,23,25,21,22,9,8,39,0,,
3876,10,154,84,238,43,24,20,21,25,13,2,2,17,0,,
3877,3,180,93,273,55,23,24,28,20,9,6,2,17,0,,
3877,4,225,91,316,80,36,8,20,28,20,14,3,37,0,,
3878,7,199,147,346,63,33,16,38,21,18,7,2,27,0,,
3878,15,192,102,294,56,21,21,21,38,16,10,3,29,0,,
3879,2,186,129,315,49,23,10,25,27,19,7,2,28,0,,
3879,12,179,93,272,63,18,16,27,25,17,17,1,35,0,,
3880,9,213,108,321,76,30,20,26,32,15,13,1,29,0,,
3880,8,213,108,321,73,25,14,32,26,16,9,3,28,0,,
3881,14,222,105,327,67,32,12,29,33,14,13,5,32,0,,
3881,1,218,89,307,85,35,17,33,29,14,7,2,23,0,,
3882,13,205,118,323,75,21,28,26,26,16,10,3,29,0,,
3882,6,173,134,307,60,40,11,24,26,13,7,2,22,0,,
3883,4,204,78,282,59,31,29,39,37,15,13,6,34,0,,
3883,13,185,98,283,53,27,41,37,39,13,8,1,22,0,,
3884,14,186,102,288,58,31,21,24,29,14,10,1,25,0,,
3884,8,203,97,300,61,38,22,29,24,16,16,2,34,0,,
3885,3,187,105,292,68,41,7,25,28,16,14,1,31,0,,
3885,7,212,111,323,85,19,18,28,22,11,15,2,28,0,,
3886,5,237,155,392,84,43,30,33,21,24,14,3,41,0,,
3886,2,190,127,317,66,15,11,21,33,14,11,3,28,0,,
3887,12,218,101,319,73,25,27,26,28,27,16,1,44,0,,
3887,9,170,101,271,46,22,11,31,26,12,7,1,20,0,,
3888,1,231,135,366,76,33,18,34,25,22,7,4,33,0,,
3888,11,180,141,321,51,15,13,25,34,8,5,3,16,0,,
3889,10,172,98,270,45,22,27,25,20,11,15,2,28,0,,
3889,6,197,130,327,74,28,19,25,25,21,7,3,31,0,,
3890,15,222,109,331,58,31,26,27,28,18,9,2,29,0,,
3890,2,219,131,350,67,24,8,28,27,17,14,2,33,0,,
3891,14,201,93,294,73,36,14,35,26,21,8,2,31,0,,
3891,13,181,118,299,61,28,31,26,35,8,11,4,23,0,,
3892,9,171,81,252,68,19,17,26,37,9,8,2,19,0,,
3892,5,186,92,278,54,35,25,37,26,14,17,2,33,0,,
3893,7,221,153,374,82,30,14,46,34,11,13,5,29,0,,
3893,1,199,120,319,60,27,19,34,46,15,5,2,22,0,,
3894,8,186,106,292,60,26,13,24,28,7,9,3,19,0,,
3894,12,187,104,291,57,37,17,28,24,9,10,2,21,0,,
3895,4,212,106,318,66,35,27,33,25,16,9,2,27,0,,
3895,10,181,116,297,61,20,29,25,33,8,6,0,14,0,,
3896,6,196,104,300,60,32,17,27,29,10,15,2,27,0,,
3896,3,204,80,284,68,32,32,29,27,11,14,0,25,0,,
3897,10,194,99,293,50,15,13,24,35,14,8,4,26,0,,
3897,5,201,111,312,71,34,18,35,24,17,11,1,29,0,,
3898,8,227,97,324,98,28,24,23,23,20,13,0,33,0,,
3898,15,194,107,301,63,25,14,23,23,14,12,0,26,0,,
3899,3,216,92,308,72,36,19,25,26,13,13,2,28,0,,
3899,1,207,100,307,72,21,15,24,25,10,14,3,27,0,,
3900,6,188,96,284,54,34,14,24,28,10,8,5,23,0,,
3900,9,193,98,291,73,35,18,28,24,16,15,3,34,0,,
3901,7,218,127,345,73,41,25,31,20,15,4,1,20,0,,
3901,4,202,79,281,68,28,14,20,31,3,7,4,14,0,,
3902,11,154,127,281,53,24,35,34,20,9,6,7,22,0,,
3902,13,187,103,290,48,21,28,20,34,18,6,2,26,0,,
3903,2,192,116,308,69,21,23,22,25,12,9,2,23,0,,
3903,14,231,112,343,95,24,23,25,22,24,18,3,45,0,,
3904,5,234,101,335,97,22,12,29,25,10,21,2,33,0,,
3904,3,211,80,291,88,19,12,25,29,8,12,1,21,0,,
3905,13,227,128,355,98,20,25,29,30,23,11,1,35,0,,
3905,2,173,91,264,58,20,18,30,29,10,12,3,25,0,,
3906,8,196,80,276,62,24,13,27,33,7,10,3,20,0,,
3906,7,239,140,379,92,30,16,33,27,19,16,0,35,0,,
3907,14,193,97,290,55,36,22,39,29,12,5,0,17,0,,
3907,4,196,114,310,62,43,24,29,39,15,6,0,21,0,,
3908,1,230,149,379,89,40,24,33,37,15,10,3,28,0,,
3908,10,195,102,297,60,40,11,37,33,8,9,0,17,0,,
3909,12,195,114,309,68,27,16,26,31,15,18,0,33,0,,
3909,15,198,84,282,64,31,14,31,26,15,10,1,26,0,,
3910,11,207,158,365,61,31,32,25,26,21,4,2,27,0,,
3910,6,195,109,304,59,23,16,26,25,7,3,2,12,0,,
3911,4,211,122,333,80,35,38,23,30,29,8,4,41,0,,
3911,9,157,79,236,45,17,25,30,23,8,7,0,15,0,,
3912,1,227,114,341,88,25,19,33,27,24,8,0,32,0,,
3912,15,208,118,326,79,27,18,27,33,16,8,1,25,0,,
3913,3,153,93,246,53,19,18,32,24,8,7,1,16,0,,
3913,8,254,92,346,96,37,18,24,36,32,22,2,56,0,,
3914,5,215,106,321,83,35,22,31,20,14,15,1,30,0,,
3914,13,215,101,316,90,26,20,20,31,16,13,0,29,0,,
3915,7,208,161,369,93,34,21,24,30,14,17,1,32,0,,
3915,6,200,127,327,53,40,16,30,24,10,21,3,34,0,,
3916,10,207,115,322,68,28,14,22,33,20,8,2,30,0,,
3916,12,184,91,275,41,32,22,34,22,21,10,3,34,0,,
3917,2,195,80,275,63,16,18,28,26,7,9,2,18,0,,
3917,11,204,156,360,61,28,18,26,28,24,13,6,43,0,,
3918,15,205,109,314,75,35,18,27,40,15,16,5,36,0,,
3918,10,196,95,291,64,28,18,40,27,11,14,0,25,0,,
3919,6,182,100,282,57,41,10,25,19,10,7,1,18,0,,
3919,14,219,120,339,65,30,30,19,25,17,16,2,35,0,,
3920,13,210,101,311,96,22,26,29,29,13,15,1,29,0,,
3920,3,220,124,344,120,17,12,29,29,19,9,3,31,0,,
3921,8,207,114,321,82,24,18,22,31,11,14,2,27,0,,
3921,5,207,100,307,84,36,15,31,22,8,14,1,23,0,,
3922,4,164,84,248,63,26,46,19,24,15,10,4,29,0,,
3922,2,192,98,290,56,20,32,24,19,12,9,3,24,0,,
3923,7,206,133,339,83,29,12,23,31,12,11,4,27,0,,
3923,12,210,108,318,65,42,20,31,23,18,14,0,32,0,,
3924,9,210,137,347,74,19,26,29,26,11,8,3,22,0,,
3924,11,196,136,332,60,38,24,26,29,17,7,1,25,0,,
3925,4,210,138,348,73,31,33,31,33,14,17,5,36,0,,
3925,6,189,94,283,65,19,38,33,31,10,12,4,26,0,,
3926,12,202,89,291,69,26,17,41,34,19,18,4,41,0,,
3926,1,161,79,240,55,23,15,32,41,7,10,2,19,0,,
3927,2,189,103,292,63,21,15,29,25,13,5,3,21,0,,
3927,8,240,149,389,108,19,16,25,29,25,19,1,45,0,,
3928,14,218,107,325,58,24,26,31,27,23,11,2,36,0,,
3928,9,174,103,277,40,39,25,27,30,9,4,0,13,0,,
3929,11,193,153,346,56,30,15,29,30,13,12,3,28,0,,
3929,7,209,147,356,89,22,15,30,29,10,17,0,27,0,,
3930,10,192,130,322,90,19,14,28,21,13,9,1,23,0,,
3930,13,219,108,327,79,27,24,21,28,21,12,1,34,0,,
3931,15,190,107,297,54,20,19,28,25,14,8,0,22,0,,
3931,5,214,140,354,55,42,25,25,28,14,11,3,28,0,,
3932,6,204,124,328,59,31,18,35,35,20,10,3,33,0,,
3932,2,206,128,334,64,25,8,35,35,14,8,6,28,0,,
3933,3,249,131,380,94,32,15,24,17,20,14,5,39,0,,
3933,15,195,99,294,62,29,15,18,24,10,11,0,21,0,,
3934,12,197,81,278,52,30,17,36,38,12,13,1,26,0,,
3934,5,210,108,318,61,38,10,38,36,15,10,2,27,0,,
3935,9,216,110,326,75,28,21,27,30,19,13,2,34,0,,
3935,10,190,109,299,74,19,10,30,27,9,16,0,25,0,,
3936,13,209,70,279,45,30,33,18,26,6,5,2,13,0,,
3936,7,193,87,280,58,48,26,26,18,8,9,1,18,0,,
3937,1,228,57,285,55,27,22,44,42,7,9,2,18,0,,
3937,4,189,58,247,36,21,12,42,42,3,4,1,8,0,,
3938,11,223,183,406,69,28,25,29,11,24,22,3,49,0,,
3938,14,171,87,258,56,15,19,11,29,11,11,1,23,0,,
3939,10,190,108,298,70,18,9,14,26,13,16,1,30,0,,
3939,2,190,119,309,60,13,12,26,14,18,15,2,35,0,,
3940,6,181,112,293,61,28,12,20,22,14,10,2,26,0,,
3940,15,202,117,319,65,31,19,22,20,19,14,2,35,0,,
3941,13,205,97,302,77,30,29,30,26,20,10,0,30,0,,
3941,8,218,115,333,86,25,15,26,29,22,14,3,39,0,,
3942,14,208,106,314,88,21,16,26,33,16,13,1,30,0,,
3942,3,208,132,340,87,24,17,34,26,9,10,0,19,0,,
3943,1,229,138,367,89,26,17,26,36,19,16,1,36,0,,
3943,9,181,114,295,59,19,18,37,29,11,8,0,19,0,,
3944,5,219,125,344,63,26,19,35,32,13,9,0,22,0,,
3944,11,212,142,354,65,19,24,32,35,11,13,3,27,0,,
3945,4,223,99,322,66,60,39,27,21,18,11,1,30,0,,
3945,12,180,82,262,56,25,54,22,27,12,11,4,27,0,,
3946,7,201,123,324,77,31,20,24,32,13,11,2,26,0,,
3946,5,181,108,289,58,18,14,32,24,12,10,1,23,0,,
3947,4,209,88,297,83,31,37,28,32,14,14,2,30,0,,
3947,8,196,104,300,72,25,46,32,28,12,12,3,27,0,,
3948,14,215,115,330,77,22,29,20,25,26,12,4,42,0,,
3948,1,179,84,263,68,39,22,25,20,17,9,0,26,0,,
3949,1,213,119,332,68,60,20,37,33,19,4,1,24,0,,
3949,7,190,139,329,64,32,22,33,37,14,5,1,20,0,,
3950,4,241,109,350,75,40,19,26,34,20,11,2,33,0,,
3950,14,195,97,292,72,32,26,34,24,14,9,2,25,0,,
3951,14,211,103,314,87,29,14,38,48,22,16,1,39,0,,
3951,1,173,79,252,41,46,13,48,38,12,12,1,25,0,,
3952,4,190,70,260,47,54,17,26,30,16,16,1,33,0,,
3952,14,184,78,262,51,37,19,30,26,12,12,1,25,0,,
3953,11,225,145,370,93,19,11,24,24,24,8,3,35,0,,
3953,8,224,116,340,75,14,13,24,24,9,13,2,24,0,,
3954,7,218,106,324,75,24,14,24,27,16,9,2,27,0,,
3954,2,202,108,310,76,20,9,27,24,12,8,2,22,0,,
3955,4,227,106,333,58,20,24,24,32,14,14,1,29,0,,
3955,13,206,84,290,57,11,35,32,24,2,5,3,10,0,,
3956,1,194,130,324,56,21,9,19,20,11,8,2,21,0,,
3956,5,222,121,343,87,19,17,20,19,21,17,3,41,0,,
3957,6,183,103,286,65,7,11,24,27,6,13,0,19,0,,
3957,13,230,92,322,85,23,20,27,24,27,17,1,45,0,,
3958,5,216,102,318,72,16,15,32,30,8,9,1,18,0,,
3958,4,217,71,288,58,23,20,30,32,13,7,0,20,0,,
3959,9,223,51,274,70,13,12,23,22,8,9,1,18,0,,
3959,15,223,103,326,59,15,15,22,23,15,11,3,29,0,,
3960,11,181,149,330,55,43,14,21,27,12,6,3,21,0,,
3960,12,213,137,350,61,34,22,27,21,15,11,3,29,0,,
3961,8,228,103,331,71,32,25,24,27,25,16,0,41,0,,
3961,10,165,106,271,54,28,25,27,24,10,15,0,25,0,,
3962,14,195,100,295,57,22,31,22,31,18,18,4,40,0,,
3962,7,203,81,284,61,24,10,31,22,16,7,1,24,0,,
3963,2,198,90,288,49,23,15,24,19,17,5,2,24,0,,
3963,3,207,122,329,69,26,22,19,24,16,13,4,33,0,,
3964,8,225,101,326,73,28,18,22,26,20,15,1,36,0,,
3964,2,224,107,331,91,11,6,26,22,11,10,3,24,0,,
3965,5,214,110,324,68,30,23,25,22,16,17,4,37,0,,
3965,6,178,91,269,50,20,11,22,25,8,8,2,18,0,,
3966,15,191,106,297,59,17,12,20,20,13,11,5,29,0,,
3966,3,214,101,315,75,9,22,20,20,25,13,4,42,0,,
3967,12,222,144,366,81,28,32,24,14,18,18,1,37,0,,
3967,9,198,101,299,69,17,10,14,24,9,12,4,25,0,,
3968,13,221,77,298,71,18,27,24,25,21,15,4,40,0,,
3968,7,206,140,346,56,15,15,25,24,24,8,2,34,0,,
3969,1,196,106,302,55,25,13,31,20,10,7,1,18,0,,
3969,14,229,102,331,74,27,19,20,31,15,22,5,42,0,,
3970,10,199,106,305,70,18,23,16,22,15,13,5,33,0,,
3970,11,192,92,284,57,13,13,22,16,19,16,2,37,0,,
3971,4,201,116,317,67,20,42,17,23,18,16,3,37,0,,
3971,15,172,82,254,47,11,28,23,17,8,6,1,15,0,,
3972,2,203,115,318,70,26,11,22,17,19,12,1,32,0,,
3972,10,208,133,341,67,19,20,17,22,24,16,4,44,0,,
3973,6,192,116,308,62,26,13,21,14,12,16,2,30,0,,
3973,1,197,112,309,66,15,14,14,21,15,13,3,31,0,,
3974,7,195,106,301,55,21,13,34,20,13,14,2,29,0,,
3974,5,210,100,310,69,25,15,20,34,13,16,0,29,0,,
3975,13,221,90,311,67,28,8,28,22,23,12,5,40,0,,
3975,12,185,135,320,65,39,15,22,28,17,6,2,25,0,,
3976,3,218,123,341,76,27,17,31,25,12,16,4,32,0,,
3976,11,189,114,303,56,28,15,25,31,6,8,3,17,0,,
3977,9,200,96,296,70,24,7,26,29,12,13,3,28,0,,
3977,14,236,103,339,67,13,37,29,26,27,26,2,55,0,,
3978,10,198,102,300,63,22,14,16,15,19,13,3,35,0,,
3978,3,196,82,278,67,19,20,15,16,24,11,6,41,0,,
3979,13,217,104,321,55,20,21,22,29,28,10,4,42,0,,
3979,15,183,120,303,52,19,10,29,22,17,8,2,27,0,,
3980,1,205,130,335,80,13,13,17,27,17,13,3,33,0,,
3980,8,215,80,295,77,26,14,29,17,16,9,2,27,0,,
3981,6,215,111,326,75,12,19,27,20,12,15,2,29,0,,
3981,2,211,91,302,80,24,7,20,27,16,12,5,33,0,,
3982,5,236,145,381,58,28,21,27,23,16,18,1,35,0,,
3982,9,196,120,316,77,40,16,23,27,14,6,3,23,0,,
3983,14,203,102,305,59,27,15,25,31,13,15,2,30,0,,
3983,12,189,107,296,63,21,21,31,25,8,8,2,18,0,,
3984,4,208,116,324,69,21,33,29,19,19,13,3,35,0,,
3984,11,178,122,300,51,18,30,19,29,9,10,1,20,0,,
3985,15,214,116,330,67,30,17,25,23,27,24,2,53,0,,
3985,10,163,93,256,47,20,19,23,25,21,6,2,29,0,,
3986,5,216,130,346,74,27,21,26,14,10,15,2,27,0,,
3986,13,219,100,319,83,19,16,14,26,17,11,0,28,0,,
3987,14,177,95,272,53,22,25,17,19,13,10,1,24,0,,
3987,4,219,92,311,75,32,14,19,17,19,16,4,39,0,,
3988,12,217,101,318,74,32,27,22,23,13,15,1,29,0,,
3988,7,199,116,315,59,25,7,23,22,7,18,0,25,0,,
3989,9,201,142,343,82,29,12,13,14,12,11,0,23,0,,
3989,3,237,79,316,87,14,24,14,13,16,15,3,34,0,,
3990,6,185,88,273,56,20,29,35,22,11,8,0,19,0,,
3990,8,228,120,348,54,20,35,22,35,36,13,2,51,0,,
3991,11,217,135,352,72,15,16,29,18,19,11,3,33,0,,
3991,1,208,127,335,76,24,17,18,29,14,9,4,27,0,,
3992,15,207,149,356,55,12,14,26,30,21,13,2,36,0,,
3992,6,203,70,273,53,31,20,30,26,14,12,1,27,0,,
3993,8,188,96,284,60,26,19,29,24,8,13,1,22,0,,
3993,4,221,112,333,71,23,13,24,29,21,16,2,39,0,,
3994,3,212,100,312,84,20,17,23,22,17,13,0,30,0,,
3994,12,211,122,333,98,36,19,22,23,13,15,1,29,0,,
3995,13,241,80,321,94,20,17,22,21,18,17,1,36,0,,
3995,9,213,172,385,98,15,8,21,22,17,9,2,28,0,,
3996,7,249,168,417,97,22,19,26,22,24,17,1,42,0,,
3996,11,188,119,307,79,14,10,22,26,4,5,2,11,0,,
3997,1,213,168,381,88,20,15,25,33,20,10,3,33,0,,
3997,2,215,117,332,70,13,13,33,25,14,15,2,31,0,,
3998,10,214,112,326,68,35,5,32,27,20,22,2,44,0,,
3998,14,168,86,254,55,20,21,27,32,14,11,3,28,0,,
3999,14,196,104,300,62,28,28,22,27,17,15,2,34,0,,
3999,15,223,107,330,71,28,5,27,22,22,16,2,40,0,,
4000,6,185,105,290,54,21,17,29,28,10,10,0,20,0,,
4000,10,216,157,373,85,14,17,28,29,21,17,4,42,0,,
3092,15,220,161,381,105,53,38,30,15,14,5,4,23,49,38.8%,28.6%
3092,8,187,144,331,102,51,39,15,30,8,7,5,20,52,28.8%,15.4%
3091,4,227,197,424,105,59,52,20,16,10,10,2,22,48,41.7%,20.8%
3091,5,263,129,392,106,87,31,16,20,13,11,1,25,67,35.8%,19.4%
4001,3,202,98,300,62,21,19,28,19,13,7,2,22,0,,
4001,4,207,107,314,58,20,10,19,28,14,8,2,24,0,,
4002,13,245,107,352,96,30,17,28,22,17,16,3,36,0,,
4002,1,214,151,365,85,15,12,22,28,12,10,0,22,0,,
4003,8,222,87,309,65,23,13,31,34,18,12,2,32,0,,
4003,12,195,104,299,54,24,22,34,31,11,11,1,23,0,,
4004,9,175,111,286,62,19,14,17,29,12,7,0,19,0,,
4004,7,214,112,326,67,25,27,29,17,21,19,3,43,0,,
4005,2,215,131,346,89,18,14,30,24,24,13,2,39,0,,
4005,5,194,141,335,61,31,23,24,30,15,11,1,27,0,,
4006,15,226,95,321,78,19,17,29,21,18,9,3,30,0,,
4006,11,216,116,332,52,18,23,21,29,18,7,3,28,0,,
4007,5,198,104,302,59,44,15,32,25,13,10,2,25,0,,
4007,14,208,103,311,58,26,23,25,32,18,21,3,42,0,,
4008,12,198,150,348,64,27,35,31,28,13,15,0,28,0,,
4008,2,208,111,319,90,19,11,28,31,12,8,1,21,0,,
4009,8,242,91,333,84,24,14,30,24,15,11,2,28,0,,
4009,3,196,83,279,73,21,21,24,30,13,8,1,22,0,,
4010,1,214,138,352,75,21,6,18,19,15,9,2,26,0,,
4010,9,236,175,411,85,14,15,19,18,14,10,2,26,0,,
4011,10,193,129,322,40,24,10,29,19,16,15,2,33,0,,
4011,7,208,113,321,86,26,22,19,29,18,10,1,29,0,,
4012,4,247,135,382,60,9,21,30,26,17,21,2,40,0,,
4012,6,171,99,270,53,11,34,26,30,3,6,2,11,0,,
4013,11,219,146,365,83,44,19,30,22,15,10,6,31,0,,
4013,13,193,114,307,59,22,10,22,30,10,10,2,22,0,,
4014,6,215,96,311,81,39,16,33,23,19,12,1,32,0,,
4014,14,195,125,320,71,19,25,23,33,14,20,2,36,0,,
4015,5,206,138,344,86,10,16,22,22,16,10,2,28,0,,
4015,8,218,119,337,86,43,26,22,22,23,12,1,36,0,,
4016,15,207,99,306,60,24,13,26,22,21,11,4,36,0,,
4016,1,183,102,285,56,17,5,22,26,18,17,2,37,0,,
4017,7,209,101,310,75,13,20,32,26,11,14,1,26,0,,
4017,3,208,107,315,84,18,15,26,32,16,13,0,29,0,,
4018,9,218,169,387,105,22,12,22,21,10,13,2,25,0,,
4018,2,197,134,331,77,26,13,21,22,12,10,0,22,0,,
4019,4,211,105,316,72,19,25,22,33,15,15,1,31,0,,
4019,10,185,127,312,47,16,21,33,22,10,10,2,22,0,,
4020,2,184,127,311,65,7,20,27,29,12,7,1,20,0,,
4020,4,208,111,319,79,28,26,29,27,17,13,2,32,0,,
4021,8,186,104,290,41,19,16,22,26,10,13,4,27,0,,
4021,7,220,131,351,79,23,25,26,22,15,11,2,28,0,,
4022,3,194,97,291,74,27,15,40,37,12,10,4,26,0,,
4022,13,196,92,288,61,25,18,37,40,12,8,0,20,0,,
4023,15,219,140,359,58,10,14,15,29,18,17,5,40,0,,
4023,5,195,127,322,62,37,16,29,15,17,11,1,29,0,,
4024,14,242,125,367,85,24,35,19,29,27,11,4,42,0,,
4024,11,185,105,290,51,20,15,29,19,14,9,0,23,0,,
4025,1,228,84,312,63,16,11,25,40,8,8,1,17,0,,
4025,12,204,82,286,36,33,23,40,25,1,9,1,11,0,,
4026,10,205,109,314,74,19,23,25,17,18,11,2,31,0,,
4026,9,218,117,335,62,21,4,17,25,26,11,1,38,0,,
4027,1,229,86,315,61,14,6,49,37,4,9,2,15,0,,
4027,10,239,71,310,43,34,13,37,49,5,4,1,10,0,,
4028,12,203,81,284,40,28,22,43,31,12,9,1,22,0,,
4028,5,196,90,286,46,33,15,31,43,10,2,0,12,0,,
4029,9,200,121,321,69,19,8,25,13,14,7,2,23,0,,
4029,4,231,118,349,88,23,30,13,25,21,12,7,40,0,,
4030,11,184,100,284,31,13,14,38,39,7,5,3,15,0,,
4030,6,218,62,280,39,23,18,39,38,7,5,0,12,0,,
4031,13,208,108,316,56,17,21,35,35,13,8,4,25,0,,
4031,2,223,123,346,71,28,8,35,35,14,10,2,26,0,,
4032,7,231,130,361,75,30,20,29,22,15,9,2,26,0,,
4032,15,213,102,315,49,21,18,22,29,8,16,2,26,0,,
4033,8,201,74,275,54,41,19,35,21,13,16,2,31,0,,
4033,14,210,74,284,55,15,24,21,35,20,12,4,36,0,,
4034,4,239,118,357,87,16,26,23,21,25,12,3,40,0,,
4034,1,183,112,295,52,16,40,21,23,7,4,1,12,0,,
4035,3,203,84,287,44,18,20,29,24,10,10,4,24,0,,
4035,5,222,88,310,53,30,16,24,29,11,9,1,21,0,,
4036,8,248,81,329,64,34,24,26,33,22,14,3,39,0,,
4036,9,190,86,276,45,32,8,33,26,9,6,2,17,0,,
4037,2,216,94,310,53,15,6,34,27,6,7,4,17,0,,
4037,11,238,125,363,65,17,20,27,34,12,10,3,25,0,,
4038,6,195,85,280,58,16,42,28,19,15,8,0,23,0,,
4038,7,187,97,284,64,26,16,19,28,17,7,2,26,0,,
4039,13,195,79,274,64,30,25,29,27,16,7,1,24,0,,
4039,14,208,107,315,51,18,21,27,29,20,13,1,34,0,,
4040,10,214,109,323,64,24,10,22,19,18,14,2,34,0,,
4040,12,205,129,334,67,17,33,19,22,17,5,3,25,0,,
4041,2,205,123,328,60,9,13,14,28,19,10,4,33,0,,
4041,15,225,129,354,74,25,16,28,14,26,14,2,42,0,,
4042,3,207,112,319,45,10,14,29,21,17,16,4,37,0,,
4042,6,184,102,286,56,23,15,21,29,12,9,2,23,0,,
4043,5,233,163,396,90,34,31,18,23,20,21,2,43,0,,
4043,10,153,119,272,36,26,15,23,18,6,6,2,14,0,,
4044,12,190,138,328,62,35,32,27,23,12,10,1,23,0,,
4044,4,186,82,268,39,16,12,23,27,11,11,3,25,0,,
4045,13,197,95,292,69,23,14,21,26,11,9,2,22,0,,
4045,8,218,126,344,94,40,13,26,21,19,12,1,32,0,,
4046,7,211,169,380,69,25,18,21,18,16,6,0,22,0,,
4046,1,196,111,307,64,27,14,18,21,8,19,2,29,0,,
4047,11,222,182,404,94,15,10,22,24,23,13,5,41,0,,
4047,9,216,112,328,78,17,11,24,22,13,11,1,25,0,,
4048,15,193,145,338,61,16,9,21,23,18,7,0,25,0,,
4048,8,251,92,343,70,31,23,23,21,27,15,2,44,0,,
4049,14,195,127,322,54,23,19,14,25,19,12,5,36,0,,
4049,2,204,102,306,79,39,8,25,14,14,13,1,28,0,,
4050,1,250,153,403,103,32,7,34,14,11,20,3,34,0,,
4050,3,191,173,364,70,15,18,14,34,6,6,1,13,0,,
4051,6,202,109,311,61,22,12,34,25,6,5,0,11,0,,
4051,12,222,106,328,62,30,26,25,34,8,11,1,20,0,,
4052,5,258,183,441,95,28,36,27,13,23,21,1,45,0,,
4052,11,174,119,293,61,21,10,13,27,5,3,4,12,0,,
4053,4,215,119,334,67,25,45,19,19,21,9,2,32,0,,
4053,7,189,123,312,76,14,36,19,19,14,8,1,23,0,,
4054,10,179,84,263,58,23,12,11,14,14,10,0,24,0,,
4054,13,217,138,355,79,22,20,14,11,26,18,3,47,0,,
4055,13,201,120,321,61,14,25,20,18,11,8,2,21,0,,
4055,4,215,125,340,65,32,12,18,20,14,11,5,30,0,,
4056,5,235,188,423,80,24,13,26,12,20,13,0,33,0,,
4056,1,195,101,296,79,28,16,12,26,13,1,1,15,0,,
4057,12,206,102,308,60,39,22,32,31,14,4,1,19,0,,
4057,15,221,96,317,62,20,8,31,32,13,14,3,30,0,,
4058,8,237,122,359,96,42,17,24,17,23,18,2,43,0,,
4058,11,200,114,314,64,18,17,17,24,14,10,1,25,0,,
4059,2,187,128,315,72,15,13,23,23,13,13,5,31,0,,
4059,7,212,134,346,95,17,30,23,23,18,14,2,34,0,,
4060,9,236,134,370,74,32,26,20,23,26,13,1,40,0,,
4060,6,202,114,316,57,16,13,23,20,15,13,2,30,0,,
4061,14,203,94,297,63,28,24,24,32,13,18,3,34,0,,
4061,3,168,100,268,54,27,18,32,24,10,12,3,25,0,,
4062,4,242,125,367,87,28,31,26,28,20,11,4,35,0,,
4062,5,192,101,293,64,16,32,28,26,8,3,3,14,0,,
4063,3,187,67,254,46,37,28,27,23,6,3,4,13,0,,
4063,2,231,85,316,53,19,8,23,27,7,13,5,25,0,,
4064,7,194,95,289,56,23,31,35,20,9,13,0,22,0,,
4064,14,194,100,294,66,29,18,20,35,18,7,1,26,0,,
4065,13,223,83,306,68,34,16,20,24,12,17,3,32,0,,
4065,6,204,135,339,55,22,4,24,20,7,12,1,20,0,,
4066,15,240,101,341,73,23,9,12,21,15,11,2,28,0,,
4066,9,231,61,292,50,19,19,21,12,14,5,1,20,0,,
4067,12,200,82,282,56,32,22,31,23,6,8,4,18,0,,
4067,11,213,110,323,66,19,10,23,31,7,12,1,20,0,,
4068,10,190,153,343,74,20,9,20,26,14,16,3,33,0,,
4068,8,213,100,313,65,38,17,26,20,15,23,1,39,0,,
4069,3,215,153,368,92,30,19,19,24,19,6,3,28,0,,
4069,15,200,113,313,50,20,4,24,19,5,14,5,24,0,,
4070,7,213,144,357,75,22,21,28,26,16,11,3,30,0,,
4070,13,213,93,306,75,18,20,26,28,17,9,0,26,0,,
4071,2,211,114,325,87,20,12,16,13,13,7,3,23,0,,
4071,8,213,112,325,70,27,16,13,16,13,14,2,29,0,,
4072,6,198,141,339,65,30,15,25,27,15,20,1,36,0,,
4072,5,194,143,337,75,24,27,27,25,18,14,2,34,0,,
4073,9,218,130,348,88,24,16,8,18,14,14,2,30,0,,
4073,12,209,150,359,71,14,24,18,8,12,20,1,33,0,,
4074,11,203,175,378,72,30,23,21,19,16,19,3,38,0,,
4074,10,192,144,336,71,28,32,19,21,19,6,2,27,0,,
4075,14,235,136,371,77,21,28,31,31,20,15,1,36,0,,
4075,1,206,127,333,71,16,12,31,31,10,7,1,18,0,,
4076,15,209,88,297,60,29,19,17,13,12,9,4,25,0,,
4076,4,194,92,286,59,25,13,13,17,11,15,1,27,0,,
4077,5,198,132,330,60,33,27,23,26,13,6,1,20,0,,
4077,7,191,107,298,50,28,11,26,23,7,11,0,18,0,,
4078,12,192,114,306,64,30,26,16,25,10,6,2,18,0,,
4078,13,222,108,330,73,20,12,25,16,11,13,1,25,0,,
4079,1,211,170,381,71,16,20,21,28,16,11,1,28,0,,
4079,6,178,127,305,43,30,12,28,21,7,9,0,16,0,,
4080,14,205,127,332,69,24,30,22,16,24,14,1,39,0,,
4080,9,167,115,282,50,17,15,16,22,8,10,0,18,0,,
4081,11,206,131,337,73,19,13,21,22,16,8,4,28,0,,
4081,3,205,174,379,84,32,27,22,20,12,7,2,21,0,,
4082,10,205,141,346,69,15,18,13,19,14,14,1,29,0,,
4082,2,202,138,340,71,21,9,19,13,12,18,2,32,0,,
4083,3,218,144,362,86,22,18,36,19,22,17,2,41,0,,
4083,10,177,109,286,57,28,14,19,36,12,10,2,24,0,,
4084,12,196,108,304,68,49,18,23,12,16,9,0,25,0,,
4084,14,215,121,336,52,28,22,12,23,14,15,4,33,0,,
4085,9,208,115,323,80,16,21,17,18,10,10,1,21,0,,
4085,5,253,140,393,85,18,24,18,17,26,12,4,42,0,,
4086,15,187,105,292,67,16,16,23,21,13,9,1,23,0,,
4086,13,238,80,318,104,27,15,21,23,20,18,2,40,0,,
4087,8,205,130,335,62,21,18,20,21,12,10,1,23,0,,
4087,1,204,158,362,76,19,15,21,20,10,8,1,19,0,,
4088,11,223,197,420,77,15,25,23,18,11,14,0,25,0,,
4088,4,207,102,309,68,19,20,18,23,14,9,2,25,0,,
4089,2,188,125,313,52,12,9,23,29,13,17,2,32,0,,
4089,6,199,141,340,62,20,32,29,23,23,16,2,41,0,,
4090,4,207,124,331,55,40,29,26,21,11,14,2,27,0,,
4090,14,193,111,304,63,25,48,21,26,12,8,1,21,0,,
4091,8,261,134,395,78,30,23,25,20,28,24,3,55,0,,
4091,6,164,86,250,55,23,13,20,25,10,8,1,19,0,,
4092,13,224,86,310,87,25,11,15,24,8,6,1,15,0,,
4092,5,248,172,420,105,38,19,24,15,19,12,1,32,0,,
4093,7,216,150,366,87,20,22,27,24,23,16,1,40,0,,
4093,12,208,138,346,85,28,17,24,27,15,11,0,26,0,,
4094,3,230,135,365,92,25,21,25,14,23,15,4,42,0,,
4094,9,195,88,283,69,17,12,14,25,17,10,0,27,0,,
4095,1,232,132,364,90,14,12,28,28,8,15,1,24,0,,
4095,11,215,112,327,64,17,17,28,28,6,4,0,10,0,,
4096,10,196,128,324,60,22,18,23,20,13,17,5,35,0,,
4096,15,227,95,322,93,16,21,20,23,20,14,2,36,0,,
4097,11,202,140,342,75,16,16,21,20,12,8,1,21,0,,
4097,7,219,148,367,86,21,20,20,21,20,10,2,32,0,,
4098,14,204,126,330,75,41,23,16,22,17,12,1,30,0,,
4098,10,186,129,315,52,41,16,22,16,13,10,0,23,0,,
4099,6,193,164,357,69,23,31,16,17,22,15,1,38,0,,
4099,15,209,92,301,55,18,16,17,16,21,13,8,42,0,,
4100,12,201,127,328,76,14,21,18,15,12,10,2,24,0,,
4100,3,204,116,320,73,23,15,15,18,13,9,1,23,0,,
4101,2,223,140,363,81,25,10,24,25,14,8,3,25,0,,
4101,1,199,131,330,76,14,12,25,24,11,12,0,23,0,,
4102,9,212,151,363,85,32,12,30,19,13,12,1,26,0,,
4102,13,226,122,348,76,15,26,19,30,15,10,3,28,0,,
4103,4,204,88,292,57,26,38,37,26,15,7,2,24,0,,
4103,8,179,111,290,42,20,29,26,37,11,7,2,20,0,,
4104,10,197,161,358,70,25,26,24,18,21,14,0,35,0,,
4104,6,187,116,303,62,23,12,18,24,13,15,1,29,0,,
4105,5,219,144,363,85,16,22,21,24,18,17,1,36,0,,
4105,2,178,120,298,62,17,8,24,21,14,5,4,23,0,,
4106,12,158,139,297,48,38,26,26,20,8,10,0,18,0,,
4106,8,244,139,383,81,33,23,20,26,23,14,4,41,0,,
4107,15,210,111,321,60,27,6,23,25,8,7,3,18,0,,
4107,14,221,118,339,72,27,32,25,23,13,8,4,25,0,,
4108,7,221,184,405,93,26,31,24,15,27,12,0,39,0,,
4108,9,193,154,347,53,21,12,15,24,7,11,1,19,0,,
4109,1,220,152,372,95,19,8,28,20,6,8,1,15,0,,
4109,13,223,99,322,87,21,19,20,28,8,7,1,16,0,,
4110,4,230,101,331,86,19,22,30,25,16,16,3,35,0,,
4110,3,202,115,317,56,18,44,25,30,7,10,0,17,0,,
4111,7,193,188,381,77,30,24,15,17,24,12,2,38,0,,
4111,10,187,111,298,50,30,17,17,15,17,14,3,34,0,,
4112,6,165,85,250,45,21,17,15,22,14,14,1,29,0,,
4112,4,172,97,269,47,23,10,22,15,12,15,2,29,0,,
4113,3,197,94,291,80,20,25,19,16,9,8,1,18,0,,
4113,8,265,157,422,90,42,18,16,19,21,16,1,38,0,,
4114,9,230,147,377,84,27,3,22,25,8,13,1,22,0,,
4114,1,237,135,372,82,21,19,25,22,14,11,3,28,0,,
4115,14,218,117,335,79,30,22,33,25,16,9,2,27,0,,
4115,5,212,127,339,89,34,5,25,33,8,14,4,26,0,,
4116,2,183,128,311,55,19,9,23,20,20,12,6,38,0,,
4116,12,203,105,308,90,25,26,20,23,18,13,2,33,0,,
4117,11,230,160,390,68,16,29,18,18,28,12,0,40,0,,
4117,15,201,107,308,81,12,13,18,18,16,10,1,27,0,,
4118,13,213,75,288,82,36,12,36,25,17,7,4,28,0,,
4118,3,189,103,292,58,25,8,25,36,11,9,0,20,0,,
4119,14,202,100,302,60,35,23,30,22,15,13,1,29,0,,
4119,7,202,105,307,73,36,12,22,30,14,11,2,27,0,,
4120,8,238,106,344,71,20,34,27,27,18,15,1,34,0,,
4120,4,218,86,304,64,38,24,27,27,15,8,3,26,0,,
4121,8,212,94,306,79,34,18,21,24,13,14,3,30,0,,
4121,14,206,102,308,72,23,21,24,21,13,12,3,28,0,,
4122,4,229,104,333,75,28,16,16,21,17,15,0,32,0,,
4122,13,201,65,266,65,30,20,21,16,12,6,1,19,0,,
4123,4,199,65,264,51,39,10,16,24,11,10,3,24,0,,
4123,14,209,79,288,38,30,38,24,16,8,14,2,24,0,,
4124,8,234,77,311,83,20,27,17,25,20,14,5,39,0,,
4124,4,181,68,249,61,32,15,25,17,13,8,0,21,0,,
4126,11,188,137,325,92,32,31,29,19,14,8,2,24,48,45.8%,29.2%
4126,5,219,102,321,107,52,41,19,29,19,9,2,30,48,58.3%,39.6%
4127,8,213,134,347,114,54,24,19,25,18,13,6,37,65,47.7%,27.7%
4127,1,221,202,423,137,47,31,25,19,11,6,4,21,41,41.5%,26.8%
4128,10,199,92,291,79,62,57,20,20,17,7,1,25,48,50.0%,35.4%
4128,15,167,97,264,58,76,39,20,20,11,8,1,20,49,38.8%,22.4%
4129,14,212,211,423,115,56,33,19,15,17,13,4,34,52,57.7%,32.7%
4129,7,197,155,352,111,69,24,15,19,8,9,4,21,44,38.6%,18.2%
4130,1,224,122,346,110,65,29,25,27,16,9,1,26,56,44.6%,28.6%
4130,10,183,124,307,75,55,32,29,25,9,11,4,24,50,40.0%,18.0%
4131,7,249,133,382,159,46,33,22,21,17,4,0,21,43,48.8%,39.5%
4131,5,178,132,310,78,26,22,21,22,9,13,5,27,55,40.0%,16.4%
4132,14,201,197,398,116,48,35,20,22,12,5,6,23,56,30.4%,21.4%
4132,1,217,142,359,124,63,20,22,20,7,7,5,19,43,32.6%,16.3%
4133,8,238,157,395,145,49,23,28,27,18,7,3,28,51,49.0%,35.3%
4133,7,192,120,312,109,56,41,27,28,9,6,4,19,34,44.1%,26.5%
4134,14,183,195,378,81,49,45,29,21,11,12,11,34,62,37.1%,17.7%
4134,8,222,150,372,135,56,25,21,29,18,7,0,25,43,58.1%,41.9%
4135,12,200,185,385,82,57,40,20,18,4,11,5,20,56,26.8%,7.1%
4135,5,240,184,424,110,55,27,18,20,14,8,2,24,55,40.0%,25.5%
4136,16,177,200,377,73,63,40,13,18,10,10,1,21,49,40.8%,20.4%
4136,4,200,192,392,98,70,32,18,13,8,16,2,26,49,49.0%,16.3%
4137,14,185,200,385,103,86,50,24,18,15,5,4,24,37,54.1%,40.5%
4137,8,174,225,399,74,73,48,18,24,14,13,1,28,54,50.0%,25.9%
4138,9,194,179,373,118,40,31,13,12,17,9,5,31,56,46.4%,30.4%
4138,15,204,219,423,121,32,31,12,13,11,7,2,20,55,32.7%,20.0%
4139,7,236,225,461,128,77,21,18,9,16,6,4,26,51,43.1%,31.4%
4139,1,175,213,388,81,70,48,9,17,9,6,1,16,49,30.6%,18.4%
4140,13,195,125,320,88,64,32,22,14,6,12,2,20,44,40.9%,13.6%
4140,10,187,202,389,93,52,32,14,22,10,5,3,18,41,36.6%,24.4%
4141,3,210,196,406,104,75,42,19,16,14,9,3,26,55,41.8%,25.5%
4141,2,178,151,329,83,71,30,16,19,15,9,2,26,43,55.8%,34.9%
4142,11,205,219,424,101,63,47,20,26,19,13,5,37,59,54.2%,32.2%
4142,18,166,153,319,75,65,38,26,20,9,5,3,17,35,40.0%,25.7%
4143,1,215,158,373,108,68,33,18,15,16,13,1,30,51,56.9%,31.4%
4143,14,193,245,438,98,60,36,15,18,14,9,3,26,53,43.4%,26.4%
4144,12,212,253,465,96,67,32,11,16,24,7,2,33,64,48.4%,37.5%
4144,13,189,178,367,90,35,40,16,11,15,5,1,21,52,38.5%,28.8%
4145,11,196,297,493,95,73,29,17,17,18,11,3,32,57,50.9%,31.6%
4145,4,197,161,358,117,46,36,16,17,7,6,0,13,32,40.6%,21.9%
4146,9,208,134,342,104,58,34,18,18,16,8,3,27,54,44.4%,29.6%
4146,18,217,164,381,109,54,38,18,18,14,7,1,22,43,48.8%,32.6%
4147,2,191,153,344,89,87,48,23,20,14,9,0,23,39,59.0%,35.9%
4147,8,187,223,410,72,77,46,20,23,20,11,4,35,66,47.0%,30.3%
4148,7,197,175,372,98,76,60,14,17,8,9,2,19,59,28.8%,13.6%
4148,15,194,155,349,86,86,37,18,14,10,3,1,14,36,36.1%,27.8%
4149,5,201,126,327,75,68,26,15,16,13,16,3,32,61,47.5%,21.3%
4149,10,180,138,318,87,64,40,16,15,8,7,1,16,33,45.5%,24.2%
4150,16,199,145,344,91,41,46,24,17,21,14,1,36,61,57.4%,34.4%
4150,3,175,169,344,85,65,23,17,24,13,9,0,22,47,46.8%,27.7%
4151,3,197,183,380,125,65,37,19,17,17,13,1,31,47,63.8%,36.2%
4151,8,171,149,320,102,56,42,18,19,10,12,0,22,44,50.0%,22.7%
4152,14,224,171,395,110,77,49,23,17,17,12,2,31,56,51.8%,30.4%
4152,10,149,166,315,65,78,47,17,23,10,5,0,15,44,34.1%,22.7%
4153,2,206,218,424,116,59,33,20,7,10,10,1,21,45,44.4%,22.2%
4153,9,186,153,339,117,45,27,7,20,15,6,1,22,44,47.7%,34.1%
4154,12,197,199,396,90,75,21,20,9,11,14,1,26,58,43.1%,19.0%
4154,16,197,135,332,88,60,45,9,20,13,8,2,23,46,45.7%,28.3%
4155,15,184,178,362,83,67,51,17,17,20,4,1,25,49,49.0%,40.8%
4155,18,180,167,347,80,85,63,17,16,18,10,2,30,52,53.8%,34.6%
4156,11,178,214,392,87,51,28,19,19,12,12,2,26,43,55.8%,27.9%
4156,1,211,169,380,116,67,32,19,19,17,10,6,33,61,44.3%,27.9%
4157,4,212,146,358,101,29,32,18,17,12,17,1,30,55,52.7%,21.8%
4157,13,221,147,368,132,50,25,17,18,13,4,0,17,41,41.5%,31.7%
4158,5,184,172,356,78,59,31,17,18,5,7,3,15,46,26.1%,10.9%
4158,7,229,208,437,112,66,50,18,17,20,7,1,28,47,57.4%,42.6%
4159,14,214,190,404,117,45,46,15,17,18,13,1,32,51,60.8%,35.3%
4159,5,204,141,345,96,53,24,18,15,13,17,0,30,51,58.8%,25.5%
4160,7,249,182,431,129,69,28,24,32,25,9,2,36,66,51.5%,37.9%
4160,4,161,163,324,85,45,30,32,24,9,7,3,19,37,43.2%,24.3%
4161,9,206,107,313,82,80,38,25,24,15,9,1,25,52,46.2%,28.8%
4161,10,179,119,298,62,85,62,24,25,9,12,1,22,48,43.8%,18.8%
4162,12,196,145,341,107,43,34,26,21,16,15,1,32,49,63.3%,32.7%
4162,3,188,140,328,106,42,25,21,26,17,12,2,31,49,59.2%,34.7%
4163,18,221,242,463,114,41,36,22,17,22,12,3,37,57,59.6%,38.6%
4163,13,192,156,348,109,44,33,17,22,14,5,1,20,46,41.3%,30.4%
4164,15,206,168,374,99,63,49,32,21,10,8,1,19,54,33.3%,18.5%
4164,8,196,239,435,106,67,36,21,32,19,9,0,28,57,49.1%,33.3%
4165,16,192,152,344,97,58,32,24,15,11,9,5,25,41,48.8%,26.8%
4165,11,172,196,368,95,55,31,15,24,15,12,2,29,55,49.1%,27.3%
4166,1,202,170,372,103,59,32,16,18,16,11,3,30,53,50.9%,30.2%
4166,2,221,148,369,138,56,30,18,16,8,13,2,23,46,45.7%,17.4%
4167,18,200,158,358,89,50,46,29,19,5,3,3,11,37,21.6%,13.5%
4167,7,218,176,394,89,72,29,19,29,15,12,0,27,52,51.9%,28.8%
4168,3,183,151,334,75,66,29,15,9,13,14,1,28,58,46.6%,22.4%
4168,5,206,156,362,93,69,33,9,15,12,14,2,28,54,48.1%,22.2%
4169,8,214,165,379,96,79,31,23,24,11,8,0,19,52,36.5%,21.2%
4169,4,206,169,375,84,52,39,24,23,7,10,4,21,48,35.4%,14.6%
4170,16,191,120,311,76,72,62,18,22,18,13,0,31,48,64.6%,37.5%
4170,10,154,170,324,52,92,44,22,18,16,4,0,20,36,55.6%,44.4%
4171,15,190,122,312,112,61,44,15,12,7,15,1,23,47,46.8%,14.9%
4171,2,220,186,406,129,54,22,12,15,13,12,4,29,49,51.0%,26.5%
4172,14,248,242,490,93,90,65,17,19,18,17,1,36,75,46.7%,24.0%
4172,9,150,107,257,49,107,16,19,17,5,2,1,8,30,23.3%,16.7%
4173,1,174,165,339,83,57,35,23,14,13,9,3,25,50,44.0%,26.0%
4173,12,229,182,411,133,60,22,14,23,21,6,1,28,50,54.0%,42.0%
4174,13,162,195,357,77,61,29,22,20,4,10,0,14,44,31.8%,9.1%
4174,11,198,213,411,105,84,46,20,22,7,7,2,16,44,31.8%,15.9%
4175,15,192,166,358,98,71,33,23,18,11,16,2,29,43,62.8%,25.6%
4175,12,198,124,322,106,53,40,18,23,14,10,0,24,49,49.0%,28.6%
4176,14,190,228,418,91,75,30,25,15,14,9,0,23,49,46.9%,28.6%
4176,11,201,211,412,103,58,33,15,25,13,11,2,26,44,54.5%,29.5%
4177,1,216,217,433,97,57,23,12,9,17,9,0,26,61,42.6%,27.9%
4177,16,193,156,349,113,58,33,9,12,11,11,3,25,48,45.8%,22.9%
4178,5,227,175,402,109,61,25,15,12,12,19,4,35,57,54.4%,21.1%
4178,9,187,164,351,109,44,37,12,15,8,5,2,15,39,33.3%,20.5%
4179,10,179,119,298,70,65,47,22,21,13,13,2,28,45,57.8%,28.9%
4179,7,185,139,324,85,70,32,21,21,13,14,2,29,51,52.9%,25.5%
4180,13,201,142,343,100,71,37,20,17,12,9,1,22,47,44.7%,25.5%
4180,2,180,180,360,88,62,26,17,20,12,14,0,26,53,49.1%,22.6%
4181,18,215,199,414,108,54,32,24,26,18,12,1,31,46,65.2%,39.1%
4181,8,162,221,383,78,49,19,26,24,14,18,1,33,57,56.1%,24.6%
4182,4,201,251,452,96,58,37,18,14,14,8,3,25,49,44.9%,28.6%
4182,3,212,180,392,102,94,27,14,18,10,5,3,18,50,30.0%,20.0%
4183,16,167,164,331,72,70,46,19,18,9,9,2,20,43,41.9%,20.9%
4183,8,199,167,366,94,71,31,18,19,13,8,1,22,44,47.7%,29.5%
4184,14,231,237,468,119,61,41,23,17,18,9,2,29,63,42.9%,28.6%
4184,15,163,159,322,81,62,43,17,23,7,6,1,14,41,31.7%,17.1%
4185,13,202,253,455,102,60,25,14,14,15,4,3,22,47,40.4%,31.9%
4185,1,206,174,380,83,60,38,14,14,15,14,0,29,57,50.9%,26.3%
4186,9,192,155,347,106,65,22,19,11,18,10,1,29,58,48.3%,31.0%
4186,11,187,212,399,110,42,44,11,19,12,11,0,23,46,50.0%,26.1%
4187,10,185,202,387,98,71,38,17,14,16,8,2,26,46,52.2%,34.8%
4187,4,176,125,301,80,64,50,16,16,15,10,1,26,42,59.5%,35.7%
4188,18,195,129,324,73,67,53,20,10,14,15,3,32,54,53.7%,25.9%
4188,2,198,171,369,88,73,23,10,20,15,6,3,24,54,38.9%,27.8%
4189,5,171,172,343,65,55,31,19,19,7,10,1,18,45,37.8%,15.6%
4189,12,210,165,375,124,70,51,19,19,16,6,2,24,41,53.7%,39.0%
4190,7,224,168,392,112,58,38,16,8,13,10,2,25,48,47.9%,27.1%
4190,3,177,218,395,95,55,28,8,16,10,8,3,21,45,40.0%,22.2%
4191,12,170,184,354,61,72,42,15,13,14,8,3,25,47,46.8%,29.8%
4191,7,201,176,377,102,67,51,13,15,16,7,1,24,53,43.4%,30.2%
4192,1,236,234,470,115,56,37,17,19,21,11,0,32,61,52.5%,34.4%
4192,18,173,166,339,82,62,29,19,17,7,1,1,9,38,21.1%,18.4%
4193,2,207,197,404,122,53,24,15,11,13,13,1,27,47,55.3%,27.7%
4193,4,185,210,395,98,48,39,11,15,11,7,4,22,55,32.7%,20.0%
4194,8,173,218,391,107,53,45,18,24,7,6,3,16,38,34.2%,18.4%
4194,9,198,172,370,89,83,35,24,17,13,11,4,28,55,43.6%,23.6%
4195,11,210,170,380,88,72,56,19,17,9,6,8,23,65,23.1%,13.8%
4195,15,198,137,335,91,82,37,17,19,3,4,2,9,34,20.6%,8.8%
4196,3,224,206,430,102,61,33,27,12,19,14,3,36,59,55.9%,32.2%
4196,13,180,152,332,94,60,40,12,27,13,5,0,18,47,38.3%,27.7%
4197,10,217,201,418,86,50,59,14,10,9,10,2,21,51,37.3%,17.6%
4197,5,226,109,335,96,70,29,10,14,13,8,3,24,54,38.9%,24.1%
4198,16,190,194,384,88,62,40,13,19,11,8,1,20,46,41.3%,23.9%
4198,14,199,204,403,98,71,34,19,13,13,14,2,29,55,49.1%,23.6%
4199,3,201,169,370,90,69,36,16,15,21,7,3,31,52,53.8%,40.4%
4199,12,165,158,323,72,67,39,15,16,9,13,0,22,44,50.0%,20.5%
4200,5,216,187,403,102,59,17,11,16,26,9,4,39,66,53.0%,39.4%
4200,16,168,159,327,91,40,50,16,11,13,4,3,20,44,38.6%,29.5%
4201,11,183,154,337,96,59,47,19,18,12,10,3,25,51,43.1%,23.5%
4201,10,197,181,378,110,72,28,18,19,10,8,1,19,34,52.9%,29.4%
4202,4,175,221,396,64,70,38,23,19,16,10,1,27,51,51.0%,31.4%
4202,8,186,222,408,71,67,50,21,23,13,7,2,22,42,47.6%,31.0%
4203,9,200,206,406,102,33,37,15,11,16,14,1,31,55,54.5%,29.1%
4203,13,203,131,334,141,44,19,11,15,8,8,0,16,42,38.1%,19.0%
4204,14,225,202,427,128,49,31,24,21,18,10,4,32,53,52.8%,34.0%
4204,18,170,170,340,79,46,31,21,24,13,7,3,23,37,54.1%,35.1%
4205,15,191,189,380,94,59,28,19,13,12,14,0,26,52,50.0%,23.1%
4205,1,236,199,435,114,65,32,13,19,17,3,3,23,62,32.3%,27.4%
4206,7,196,182,378,109,77,42,22,10,13,11,3,27,53,45.3%,24.5%
4206,2,171,185,356,92,60,29,10,22,5,6,0,11,27,40.7%,18.5%
4207,5,204,158,362,93,59,45,12,15,15,12,0,27,51,52.9%,29.4%
4207,3,208,184,392,114,54,20,15,12,9,11,2,22,44,45.5%,20.5%
4208,13,213,154,367,120,89,45,13,14,17,10,0,27,47,57.4%,36.2%
4208,4,169,212,381,60,72,24,14,13,13,9,5,27,54,40.7%,24.1%
4209,18,221,202,423,124,43,36,18,6,19,14,0,33,56,58.9%,33.9%
4209,9,159,191,350,80,55,24,6,17,11,13,1,25,47,51.1%,23.4%
4210,2,158,235,393,78,45,18,16,21,13,6,1,20,35,54.3%,37.1%
4210,11,208,179,387,121,69,39,21,16,15,10,2,27,49,51.0%,30.6%
4211,1,234,219,453,131,68,36,25,14,19,15,4,38,52,65.4%,36.5%
4211,8,162,174,336,92,48,34,14,25,6,7,2,15,45,28.9%,13.3%
4212,10,196,202,398,93,56,41,12,16,15,8,2,25,61,37.7%,24.6%
4212,15,200,120,320,106,51,43,16,12,13,7,0,20,43,46.5%,30.2%
4213,7,229,141,370,121,84,32,15,23,14,6,1,21,51,39.2%,27.5%
4213,14,187,227,414,84,68,48,23,14,13,5,2,20,53,34.0%,24.5%
4214,16,218,169,387,130,32,38,16,19,15,9,1,25,46,52.2%,32.6%
4214,12,189,168,357,98,55,23,20,16,16,18,1,35,65,52.3%,24.6%
4215,12,205,180,385,112,67,33,21,18,16,13,2,31,57,50.9%,28.1%
4215,4,163,196,359,67,45,31,18,21,10,6,4,20,45,35.6%,22.2%
4216,15,192,157,349,94,71,43,24,13,12,6,3,21,48,37.5%,25.0%
4216,9,202,136,338,122,60,35,14,24,15,7,2,24,48,45.8%,31.2%
4217,1,196,168,364,90,75,40,19,15,18,7,2,27,51,49.0%,35.3%
4217,10,159,198,357,66,86,47,15,19,12,5,0,17,47,36.2%,25.5%
4218,16,210,144,354,112,58,50,17,11,17,9,1,27,48,54.2%,35.4%
4218,2,201,213,414,127,49,19,11,17,17,10,3,30,47,57.4%,36.2%
4219,7,216,205,421,115,63,22,13,10,11,11,6,28,49,44.9%,22.4%
4219,13,182,204,386,102,62,44,10,13,6,8,2,16,33,42.4%,18.2%
4220,11,178,212,390,88,67,44,12,15,16,8,2,26,56,42.9%,28.6%
4220,8,206,201,407,106,68,45,15,12,12,6,1,19,48,37.5%,25.0%
4221,3,152,202,354,66,66,30,14,17,11,4,0,15,37,40.5%,29.7%
4221,14,215,218,433,113,87,49,17,14,20,12,2,34,59,54.2%,33.9%
4222,5,213,186,399,101,56,41,14,19,17,10,2,29,46,58.7%,37.0%
4222,18,200,183,383,94,56,27,19,14,11,10,0,21,51,41.2%,21.6%
4223,8,186,211,397,100,69,35,29,17,9,13,0,22,38,57.9%,23.7%
4223,11,191,183,374,108,80,38,17,29,13,14,2,29,46,58.7%,28.3%
4224,2,176,165,341,74,52,35,17,16,8,9,2,19,33,51.5%,24.2%
4224,5,224,235,459,99,63,27,17,17,22,18,2,42,67,59.7%,32.8%
4225,4,193,165,358,95,59,30,26,25,17,6,2,25,51,45.1%,33.3%
4225,15,195,187,382,89,68,34,25,26,10,11,1,22,43,48.8%,23.3%
4226,9,175,189,364,85,54,32,20,21,12,7,5,24,47,40.4%,25.5%
4226,1,232,152,384,137,58,27,21,19,15,9,3,27,54,44.4%,27.8%
4227,10,194,126,320,86,67,40,14,20,13,8,1,22,40,52.5%,32.5%
4227,14,193,205,398,95,60,38,20,14,13,14,0,27,49,55.1%,26.5%
4228,13,232,188,420,104,61,33,8,18,20,4,3,27,60,40.0%,33.3%
4228,16,179,148,327,69,52,40,18,8,9,7,3,19,53,30.2%,17.0%
4229,18,168,144,312,72,54,55,17,18,9,8,5,22,49,34.7%,18.4%
4229,12,203,230,433,88,60,18,18,17,18,9,4,31,53,50.9%,34.0%
4230,3,203,176,379,102,68,33,22,17,16,12,2,30,47,59.6%,34.0%
4230,7,169,127,296,86,80,44,17,22,16,11,1,28,45,60.0%,35.6%
4231,14,185,180,365,104,64,29,19,11,17,13,1,31,58,51.7%,29.3%
4231,1,208,177,385,108,68,38,11,19,17,11,1,29,48,58.3%,35.4%
4232,15,207,153,360,106,57,15,19,9,14,13,1,28,43,62.8%,32.6%
4232,16,173,158,331,75,55,52,9,19,12,10,3,25,54,40.7%,22.2%
4233,11,224,192,416,109,61,46,18,15,15,11,3,29,60,43.3%,25.0%
4233,12,165,183,348,80,64,34,16,18,8,12,0,20,39,51.3%,20.5%
4234,4,193,167,360,79,45,45,19,9,9,10,2,21,45,42.2%,20.0%
4234,5,237,201,438,128,66,27,10,19,12,12,4,28,54,44.4%,22.2%
4235,2,204,164,368,108,46,28,21,18,12,10,3,25,50,44.0%,24.0%
4235,3,177,149,326,99,64,24,18,21,19,8,3,30,53,50.9%,35.8%
4236,10,208,197,405,99,69,28,17,16,18,12,3,33,56,53.6%,32.1%
4236,18,166,112,278,74,59,50,16,17,10,7,1,18,45,37.8%,22.2%
4237,7,204,186,390,104,61,55,19,15,14,13,0,27,54,50.0%,25.9%
4237,9,184,176,360,105,86,29,15,18,13,2,1,16,39,38.5%,33.3%
4238,8,241,164,405,140,43,28,15,14,17,11,1,29,58,48.3%,29.3%
4238,13,194,179,373,94,38,31,14,15,13,12,2,27,47,53.2%,27.7%
4239,9,187,163,350,87,62,40,19,15,10,11,2,23,51,41.2%,19.6%
4239,5,242,129,371,121,59,34,15,19,13,9,3,25,58,37.9%,22.4%
4240,8,205,183,388,114,39,27,21,21,12,11,2,25,49,46.9%,24.5%
4240,18,247,190,437,157,52,31,21,21,17,11,2,30,48,58.3%,35.4%
4241,10,190,139,329,91,51,33,18,25,12,12,0,24,52,46.2%,23.1%
4241,12,210,154,364,119,42,32,25,18,9,12,1,22,44,47.7%,20.5%
4242,11,177,160,337,99,61,28,22,17,13,8,0,21,48,43.8%,27.1%
4242,14,204,254,458,100,63,39,17,22,21,8,0,29,40,72.5%,52.5%
4243,7,225,193,418,111,51,25,29,16,17,7,2,26,54,44.4%,31.5%
4243,16,202,167,369,121,55,28,17,29,4,2,2,8,34,17.6%,11.8%
4244,15,223,141,364,140,75,38,18,17,10,7,2,19,42,40.5%,23.8%
4244,3,150,164,314,63,63,27,17,18,7,10,5,22,48,35.4%,14.6%
4245,2,210,188,398,127,56,22,14,23,13,10,4,27,48,47.9%,27.1%
4245,13,198,148,346,105,56,26,23,14,14,13,3,30,52,51.9%,26.9%
4246,4,201,180,381,97,66,40,20,16,17,12,2,31,58,50.0%,29.3%
4246,1,217,181,398,92,61,34,16,20,12,9,2,23,44,47.7%,27.3%
4247,2,188,240,428,97,64,31,18,10,14,3,2,19,41,41.5%,34.1%
4247,1,195,189,384,94,52,42,10,18,24,11,2,37,57,61.4%,42.1%
4248,15,166,115,281,91,68,55,22,18,9,3,0,12,29,41.4%,31.0%
4248,7,192,189,381,92,67,37,18,22,15,12,1,28,58,46.6%,25.9%
4249,9,178,170,348,86,54,34,8,15,16,10,0,26,55,47.3%,29.1%
4249,12,184,176,360,84,44,41,15,8,16,13,3,32,51,56.9%,31.4%
4250,18,229,183,412,108,56,27,17,17,14,7,3,24,52,40.4%,26.9%
4250,16,177,187,364,65,60,37,17,17,11,4,0,15,40,37.5%,27.5%
4251,3,174,221,395,76,76,32,17,12,18,5,1,24,53,43.4%,34.0%
4251,11,195,191,386,99,63,61,13,17,21,3,1,25,52,46.2%,40.4%
4252,8,188,99,287,94,61,33,28,23,12,9,5,26,44,47.7%,27.3%
4252,10,188,124,312,80,85,56,23,28,11,7,2,20,47,38.3%,23.4%
4253,4,176,189,365,74,45,32,20,24,11,10,1,22,37,56.8%,29.7%
4253,14,199,221,420,108,57,23,24,20,15,7,2,24,52,42.3%,28.8%
4254,13,173,175,348,81,41,55,18,12,8,12,0,20,43,46.5%,18.6%
4254,5,242,196,438,105,51,17,12,18,19,12,0,31,57,54.4%,33.3%
4255,11,178,225,403,97,56,37,11,30,10,6,3,19,35,45.7%,28.6%
4255,7,211,152,363,98,88,43,30,11,15,10,1,26,49,51.0%,30.6%
4256,5,224,164,388,112,57,36,16,23,17,12,3,32,64,45.3%,26.6%
4256,13,179,171,350,107,40,17,23,16,10,4,0,14,39,35.9%,25.6%
4257,14,206,166,372,111,55,32,21,31,15,15,0,30,54,55.6%,27.8%
4257,2,215,155,370,114,51,37,31,21,13,7,0,20,51,39.2%,25.5%
4258,12,237,162,399,143,59,34,17,21,18,6,5,29,58,41.4%,31.0%
4258,9,166,182,348,70,46,36,21,17,15,6,4,25,47,44.7%,31.9%
4259,10,231,132,363,109,59,73,30,25,22,9,2,33,52,59.6%,42.3%
4259,8,166,101,267,64,58,29,25,30,15,13,2,30,57,49.1%,26.3%
4260,3,231,164,395,128,53,18,21,18,16,11,2,29,49,55.1%,32.7%
4260,16,166,134,300,90,48,40,18,21,10,10,1,21,50,40.0%,20.0%
4261,1,226,171,397,113,60,31,21,20,11,10,4,25,52,40.4%,21.2%
4261,15,216,133,349,104,70,30,20,21,9,8,3,20,49,34.7%,18.4%
4262,4,193,181,374,92,47,28,20,11,19,11,0,30,52,57.7%,36.5%
4262,18,209,171,380,102,56,31,11,20,10,15,0,25,52,48.1%,19.2%
4263,2,175,173,348,93,54,23,15,23,9,12,1,22,36,58.3%,25.0%
4263,12,227,163,390,110,82,44,23,15,23,11,1,35,62,54.8%,37.1%
4264,8,163,165,328,88,62,30,29,35,16,7,0,23,47,48.9%,34.0%
4264,14,208,190,398,109,56,39,35,29,15,18,3,36,50,66.0%,30.0%
4265,5,224,153,377,117,71,41,14,18,13,5,3,21,45,40.0%,28.9%
4265,11,194,197,391,106,44,34,18,14,13,11,1,25,51,47.1%,25.5%
4266,9,237,183,420,124,67,26,30,20,14,9,2,25,63,36.5%,22.2%
4266,4,191,146,337,76,32,36,21,30,13,8,0,21,55,38.2%,23.6%
4267,7,211,153,364,108,74,35,24,16,12,8,0,20,49,40.8%,24.5%
4267,10,182,163,345,83,57,42,16,24,9,7,4,20,46,34.8%,19.6%
4268,13,191,155,346,86,62,32,25,16,10,7,0,17,40,42.5%,25.0%
4268,15,221,137,358,125,60,34,16,25,15,11,0,26,53,49.1%,28.3%
4269,18,223,193,416,108,46,34,19,19,15,14,3,32,56,51.8%,26.8%
4269,3,198,166,364,115,62,21,19,19,9,12,0,21,42,50.0%,21.4%
4270,16,165,180,345,76,65,31,21,22,13,11,5,29,51,47.1%,25.5%
4270,1,212,234,446,101,49,22,22,21,25,7,0,32,49,65.3%,51.0%
4271,1,227,176,403,113,60,47,17,13,16,13,1,30,62,46.8%,25.8%
4271,5,206,174,380,94,66,14,14,17,17,6,3,26,47,48.9%,36.2%
4272,12,165,187,352,62,81,42,16,19,16,9,4,29,56,44.6%,28.6%
4272,2,172,198,370,59,72,30,19,16,12,14,3,29,53,49.1%,22.6%
4273,10,171,170,341,75,55,39,12,11,10,11,1,22,49,42.9%,20.4%
4273,3,223,151,374,118,66,31,11,12,15,15,2,32,59,50.8%,25.4%
4274,11,199,245,444,99,61,30,12,15,19,14,2,35,58,56.9%,32.8%
4274,16,150,182,332,86,61,26,15,12,1,7,0,8,23,34.8%,4.3%
4275,9,221,182,403,128,58,28,17,20,16,9,3,28,49,51.0%,32.7%
4275,14,164,168,332,78,52,41,20,17,9,7,4,20,54,29.6%,16.7%
4276,8,188,167,355,67,80,56,23,25,10,10,3,23,47,42.6%,21.3%
4276,15,206,94,300,80,111,52,25,23,9,6,4,19,39,38.5%,23.1%
4277,13,196,194,390,92,72,30,15,18,15,10,1,26,52,48.1%,28.8%
4277,18,182,207,389,75,58,37,18,15,13,11,1,25,47,51.1%,27.7%
4278,4,190,179,369,89,57,45,15,16,11,3,1,15,37,37.8%,29.7%
4278,7,223,170,393,102,79,47,16,15,13,12,0,25,48,52.1%,27.1%
4279,12,226,194,420,113,60,28,29,23,14,9,4,27,50,46.0%,28.0%
4279,14,178,180,358,89,41,24,23,29,8,7,7,22,46,32.6%,17.4%
4280,8,169,214,383,95,68,52,23,27,7,5,2,14,43,27.9%,16.3%
4280,7,215,126,341,99,115,41,27,23,10,11,3,24,42,50.0%,23.8%
4281,1,181,187,368,67,71,31,21,13,13,19,0,32,63,50.8%,20.6%
4281,4,221,205,426,117,52,23,13,22,16,4,2,22,45,44.4%,35.6%
4282,11,195,245,440,106,39,34,14,11,9,13,1,23,57,38.6%,15.8%
4282,5,242,191,433,150,39,32,11,14,13,9,2,24,41,53.7%,31.7%
4283,3,192,194,386,93,66,38,13,18,13,8,1,22,43,48.8%,30.2%
4283,9,187,153,340,90,77,38,18,13,12,14,1,27,52,50.0%,23.1%
4284,15,202,195,397,114,52,49,17,17,19,8,1,28,45,60.0%,42.2%
4284,13,210,159,369,114,66,29,17,17,8,9,4,21,49,34.7%,16.3%
4285,2,163,99,262,75,69,24,24,25,10,8,0,18,37,48.6%,27.0%
4285,10,193,101,294,93,68,54,25,23,18,13,2,33,53,58.5%,34.0%
4286,16,209,205,414,117,55,30,16,15,17,12,2,31,55,52.7%,30.9%
4286,18,177,206,383,93,66,39,15,16,11,5,3,19,39,41.0%,28.2%
4287,15,168,209,377,84,53,49,17,19,11,6,3,20,49,34.7%,22.4%
4287,5,218,163,381,107,60,23,19,17,19,9,4,32,56,50.0%,33.9%
4288,8,199,192,391,108,67,51,14,23,16,7,3,26,48,47.9%,33.3%
4288,12,174,207,381,75,69,35,23,14,15,9,3,27,50,48.0%,30.0%
4289,4,183,162,345,67,59,26,25,21,9,17,3,29,51,51.0%,17.6%
4289,16,212,187,399,127,60,25,21,25,13,8,1,22,47,44.7%,27.7%
4290,9,192,185,377,111,70,31,11,11,17,8,1,26,47,53.2%,36.2%
4290,3,168,190,358,85,62,31,12,11,9,11,3,23,52,38.5%,17.3%
4291,18,215,184,399,108,36,44,17,15,15,10,5,30,50,50.0%,30.0%
4291,11,184,176,360,105,51,17,15,17,12,3,4,19,50,30.0%,24.0%
4292,10,197,161,358,121,59,37,15,24,14,9,1,24,51,45.1%,27.5%
4292,2,202,176,378,102,51,31,24,15,11,9,0,20,53,37.7%,20.8%
4293,13,196,166,362,101,47,21,16,15,10,7,1,18,50,34.0%,20.0%
4293,14,239,259,498,131,51,40,15,15,15,17,4,36,62,51.6%,24.2%
4294,1,179,165,344,86,52,32,12,14,11,8,2,21,46,41.3%,23.9%
4294,7,233,193,426,140,78,38,14,12,14,13,7,34,56,48.2%,25.0%
4295,3,200,168,368,112,67,20,9,20,11,3,1,15,47,29.8%,23.4%
4295,1,228,203,431,131,61,33,20,9,15,12,1,28,60,45.0%,25.0%
4296,12,184,125,309,85,72,41,15,10,19,8,2,29,48,56.2%,39.6%
4296,10,197,185,382,109,64,49,10,15,9,7,2,18,44,36.4%,20.5%
4297,14,223,237,460,104,74,25,20,16,17,14,1,32,67,46.3%,25.4%
4297,13,173,173,346,80,62,49,16,20,11,3,2,16,38,36.8%,28.9%
4298,16,180,156,336,64,69,40,16,21,7,5,0,12,34,35.3%,20.6%
4298,9,174,151,325,54,83,49,21,16,9,7,1,17,62,25.8%,14.5%
4299,5,198,178,376,88,92,30,21,17,11,9,1,21,47,42.6%,23.4%
4299,8,185,232,417,93,61,50,17,21,18,11,2,31,53,54.7%,34.0%
4300,18,202,159,361,98,76,56,22,17,17,10,0,27,46,58.7%,37.0%
4300,4,167,186,353,85,66,35,17,22,11,8,2,21,48,39.6%,22.9%
4301,2,187,169,356,85,64,28,14,18,12,10,3,25,58,37.9%,20.7%
4301,15,187,175,362,89,91,51,18,14,12,9,4,25,47,44.7%,25.5%
4302,7,259,219,478,145,73,25,16,7,15,15,0,30,49,61.2%,30.6%
4302,11,169,199,368,102,50,30,7,16,7,5,1,13,33,36.4%,21.2%
4303,4,215,202,417,102,72,29,19,12,17,20,3,40,56,66.1%,30.4%
4303,2,155,170,325,78,63,42,12,19,6,8,1,15,35,40.0%,17.1%
4304,14,231,260,491,119,54,25,24,21,14,8,2,24,50,44.0%,28.0%
4304,16,167,111,278,85,74,39,21,24,8,3,3,14,44,25.0%,18.2%
4305,8,184,157,341,94,74,44,16,25,14,13,2,29,61,44.3%,23.0%
4305,3,182,159,341,70,85,36,26,16,16,18,2,36,49,69.4%,32.7%
4306,12,167,248,415,83,68,44,24,21,16,5,3,24,51,41.2%,31.4%
4306,11,204,196,400,90,59,33,21,24,27,12,2,41,61,63.9%,44.3%
4307,18,199,150,349,73,74,45,17,21,9,10,3,22,48,39.6%,18.8%
4307,15,209,141,350,79,77,33,21,17,10,9,2,21,54,35.2%,18.5%
4308,10,184,109,293,101,68,45,8,13,14,7,1,22,41,51.2%,34.1%
4308,9,190,123,313,80,74,44,13,8,15,10,0,25,53,47.2%,28.3%
4309,13,188,183,371,106,46,27,20,19,10,6,1,17,39,41.0%,25.6%
4309,7,231,229,460,123,42,26,20,20,17,10,2,29,67,40.3%,25.4%
4310,5,189,178,367,75,35,24,11,10,10,14,2,26,51,47.1%,19.6%
4310,1,267,187,454,166,39,32,10,11,14,13,3,30,55,49.1%,25.5%
4311,12,182,95,277,50,21,15,28,29,14,11,4,29,0,,
4311,10,194,121,315,41,31,18,29,28,15,12,2,29,0,,
4312,3,232,99,331,79,23,15,29,37,20,18,3,41,0,,
4312,6,187,94,281,67,23,10,37,29,8,10,2,20,0,,
4313,14,150,73,223,49,19,15,20,28,11,8,3,22,0,,
4313,8,241,109,350,92,27,14,28,20,28,20,4,52,0,,
4314,15,203,131,334,55,9,7,21,25,12,16,1,29,0,,
4314,13,213,105,318,86,26,35,25,21,22,9,1,32,0,,
4315,9,237,137,374,99,14,16,26,27,19,17,2,38,0,,
4315,2,191,95,286,54,13,10,27,26,10,13,1,24,0,,
4316,4,201,97,298,56,13,43,30,25,14,13,3,30,0,,
4316,5,166,95,261,55,13,34,27,28,8,6,0,14,0,,
4317,1,192,100,292,75,17,11,20,16,11,12,3,26,0,,
4317,7,229,125,354,100,24,32,16,21,22,10,2,34,0,,
4318,2,171,92,263,58,19,12,35,18,9,12,2,23,0,,
4318,15,195,140,335,68,27,17,18,35,32,15,2,49,0,,
4319,6,219,98,317,69,24,20,34,24,13,19,1,33,0,,
4319,9,193,98,291,69,21,18,24,34,8,9,2,19,0,,
4320,12,194,117,311,51,30,21,27,21,13,7,2,22,0,,
4320,5,219,145,364,74,17,16,21,27,19,7,1,27,0,,
4321,13,217,113,330,79,33,33,23,16,18,18,2,38,0,,
4321,14,188,144,332,57,33,13,16,23,13,11,2,26,0,,
4322,7,236,175,411,75,30,23,38,27,18,16,3,37,0,,
4322,4,199,119,318,60,26,19,27,38,10,7,2,19,0,,
4323,3,212,72,284,68,27,19,16,30,24,12,3,39,0,,
4323,8,193,91,284,58,23,11,30,16,14,11,2,27,0,,
4324,10,166,106,272,42,21,12,25,15,10,15,3,28,0,,
4324,1,216,115,331,78,17,26,15,25,20,16,4,40,0,,
4325,7,186,118,304,58,22,29,33,21,11,9,1,21,0,,
4325,12,218,126,344,76,31,19,21,33,14,5,3,22,0,,
4326,1,186,117,303,62,19,13,26,11,7,14,3,24,0,,
4326,4,195,116,311,80,25,17,11,26,18,11,3,32,0,,
4327,8,207,101,308,66,30,20,26,21,15,18,3,36,0,,
4327,2,188,66,254,67,25,16,21,26,10,16,5,31,0,,
4328,9,221,75,296,71,13,30,27,17,14,8,3,25,0,,
4328,15,210,64,274,65,20,18,17,27,17,10,1,28,0,,
4329,5,218,105,323,67,35,28,24,28,20,6,2,28,0,,
4329,10,173,137,310,44,32,21,28,24,12,15,6,33,0,,
4330,13,216,97,313,86,35,26,24,32,18,13,1,32,0,,
4330,3,208,111,319,75,31,15,31,22,14,8,3,25,0,,
4331,14,220,122,342,76,23,33,17,31,22,16,2,40,0,,
4331,6,187,102,289,52,36,12,31,17,11,10,1,22,0,,
4332,4,222,117,339,72,13,40,29,26,17,14,4,35,0,,
4332,12,186,107,293,46,19,33,26,29,10,7,3,20,0,,
4333,8,244,128,372,81,25,18,26,20,18,11,1,30,0,,
4333,9,203,59,262,68,41,29,20,26,5,7,1,13,0,,
4334,5,246,116,362,68,36,22,24,29,14,11,1,26,0,,
4334,1,225,81,306,59,27,9,29,24,11,11,1,23,0,,
4335,2,189,82,271,66,22,6,27,23,6,11,2,19,0,,
4335,3,229,115,344,100,18,17,23,27,18,15,4,37,0,,
4336,6,197,77,274,51,15,14,23,26,9,8,2,19,0,,
4336,13,233,73,306,79,19,23,26,23,13,9,2,24,0,,
4337,15,191,127,318,66,46,16,18,17,15,18,4,37,0,,
4337,14,208,123,331,71,21,24,17,18,20,20,3,43,0,,
4338,10,207,132,339,67,21,14,18,26,13,17,2,32,0,,
4338,7,233,111,344,100,24,16,26,18,19,16,1,36,0,,
4339,12,183,133,316,55,28,23,31,30,10,16,0,26,0,,
4339,1,187,101,288,46,24,11,29,30,15,9,4,28,0,,
4340,2,213,82,295,67,28,15,27,26,21,15,2,38,0,,
4340,6,192,96,288,45,24,13,26,27,9,10,0,19,0,,
4341,7,197,113,310,64,24,14,38,33,13,12,1,26,0,,
4341,5,203,123,326,65,21,20,33,38,12,18,2,32,0,,
4342,3,194,82,276,65,34,15,28,27,11,12,3,26,0,,
4342,14,200,122,322,50,33,19,27,28,12,15,2,29,0,,
4343,8,220,108,328,82,25,19,31,26,16,8,4,28,0,,
4343,15,187,92,279,56,32,13,26,31,10,13,5,28,0,,
4344,9,213,113,326,86,19,12,37,31,8,13,0,21,0,,
4344,13,214,94,308,76,16,16,31,37,19,11,0,30,0,,
4345,4,218,129,347,98,17,31,24,21,19,11,3,33,0,,
4345,10,177,125,302,40,12,43,21,24,10,6,1,17,0,,
4346,2,176,88,264,51,21,10,35,33,9,14,0,23,0,,
4346,4,189,108,297,61,22,12,33,35,15,12,1,28,0,,
4347,14,212,168,380,76,24,21,24,27,23,13,0,36,0,,
4347,9,180,80,260,75,20,21,27,24,12,5,3,20,0,,
4348,12,210,98,308,78,27,23,29,31,20,12,1,33,0,,
4348,15,183,75,258,60,18,8,31,29,14,16,3,33,0,,
4349,5,209,112,321,72,28,11,27,28,10,14,1,25,0,,
4349,3,192,100,292,71,22,21,28,27,15,8,3,26,0,,
4350,1,211,120,331,67,32,13,17,18,12,9,1,22,0,,
4350,6,204,92,296,66,29,17,18,17,5,19,1,25,0,,
4351,7,204,103,307,65,27,24,34,21,15,11,3,29,0,,
4351,8,199,105,304,56,19,12,21,34,14,16,1,31,0,,
4352,10,216,119,335,70,25,14,20,21,14,14,0,28,0,,
4352,13,219,105,324,80,16,16,18,20,12,16,5,33,0,,
4353,13,205,102,307,60,24,28,26,28,18,7,1,26,0,,
4353,4,198,99,297,71,20,10,36,24,9,5,2,16,0,,
4354,3,200,87,287,47,22,11,37,21,13,13,0,26,0,,
4354,12,219,98,317,70,27,18,21,37,17,8,1,26,0,,
4355,5,212,120,332,84,19,21,15,27,13,13,1,27,0,,
4355,8,200,107,307,62,29,17,27,15,13,14,2,29,0,,
4356,6,217,99,316,58,26,17,26,31,18,12,1,31,0,,
4356,7,192,105,297,62,20,29,31,26,15,12,1,28,0,,
4357,15,189,70,259,69,9,14,16,23,12,13,0,25,0,,
4357,1,191,128,319,64,24,9,23,16,12,13,2,27,0,,
4358,9,217,99,316,85,21,22,25,21,14,11,1,26,0,,
4358,10,195,99,294,50,13,11,20,25,13,9,1,23,0,,
4359,14,211,145,356,69,41,15,27,23,9,24,4,37,0,,
4359,2,186,115,301,80,35,15,23,27,13,18,0,31,0,,
4360,10,198,93,291,69,29,14,25,22,15,16,1,32,0,,
4360,14,166,85,251,53,13,11,22,25,13,16,4,33,0,,
4361,12,217,113,330,74,36,24,26,29,18,16,2,36,0,,
4361,8,192,78,270,51,24,23,29,26,9,4,1,14,0,,
4362,6,190,78,268,44,16,19,20,25,9,19,2,30,0,,
4362,5,207,128,335,77,16,24,25,20,17,16,2,35,0,,
4363,13,222,119,341,73,26,16,23,26,20,12,1,33,0,,
4363,2,186,110,296,70,29,18,26,23,11,13,1,25,0,,
4364,7,212,117,329,57,27,29,38,28,12,19,3,34,0,,
4364,15,200,89,289,65,21,9,28,38,11,11,1,23,0,,
4365,4,225,113,338,77,20,20,22,23,16,20,6,42,0,,
4365,9,189,117,306,71,13,31,23,22,9,8,1,18,0,,
4366,1,207,106,313,76,23,13,31,27,11,12,0,23,0,,
4366,3,225,103,328,80,15,20,27,31,14,9,4,27,0,,
4367,12,215,112,327,86,24,17,31,30,18,15,0,33,0,,
4367,6,204,91,295,55,32,7,30,31,11,13,3,27,0,,
4368,5,243,134,377,96,23,35,26,20,26,17,3,46,0,,
4368,15,178,77,255,50,16,12,20,26,14,11,1,26,0,,
4369,3,200,144,344,76,23,25,16,26,18,15,1,34,0,,
4369,7,197,122,319,57,22,17,26,16,17,8,3,28,0,,
4370,8,222,89,311,73,30,20,31,25,14,7,1,22,0,,
4370,13,167,82,249,46,18,16,25,31,7,6,0,13,0,,
4371,9,203,96,299,68,18,12,26,23,8,7,1,16,0,,
4371,1,226,145,371,76,24,19,23,26,19,11,0,30,0,,
4372,4,186,103,289,37,23,30,31,23,16,15,1,32,0,,
4372,14,176,86,262,47,17,46,23,31,13,12,3,28,0,,
4373,2,219,125,344,99,18,19,28,33,20,18,1,39,0,,
4373,10,184,94,278,57,14,11,33,28,9,6,0,15,0,,
4374,15,199,99,298,52,19,13,35,21,17,14,2,33,0,,
4374,4,189,87,276,57,20,9,22,35,13,12,0,25,0,,
4375,7,240,129,369,78,23,21,32,31,21,21,1,43,0,,
4375,9,218,110,328,67,25,16,31,32,10,9,2,21,0,,
4376,2,198,108,306,65,37,8,23,24,15,16,2,33,0,,
4376,12,180,113,293,57,29,22,24,23,13,6,1,20,0,,
4377,5,238,139,377,71,23,22,22,29,16,12,2,30,0,,
4377,13,199,55,254,49,22,13,29,22,9,3,1,13,0,,
4378,6,233,82,315,54,24,16,29,27,15,13,0,28,0,,
4378,8,206,80,286,59,21,24,27,29,13,9,2,24,0,,
4379,10,178,115,293,64,19,15,21,17,11,7,1,19,0,,
4379,3,228,109,337,101,20,32,17,21,25,10,4,39,0,,
4380,14,189,97,286,65,35,17,28,33,14,11,1,26,0,,
4380,1,202,132,334,70,24,27,33,28,13,13,3,29,0,,
4381,3,210,75,285,70,17,17,28,26,15,7,2,24,0,,
4381,4,189,97,286,56,33,11,26,28,8,10,2,20,0,,
4382,7,184,109,293,58,22,22,31,20,15,14,0,29,0,,
4382,14,194,125,319,58,22,25,20,31,16,13,3,32,0,,
4383,8,216,119,335,82,29,19,27,16,19,16,2,37,0,,
4383,10,167,103,270,59,16,9,16,27,11,14,3,28,0,,
4384,9,203,133,336,59,20,15,31,22,10,13,0,23,0,,
4384,5,204,133,337,68,27,17,22,31,15,17,0,32,0,,
4385,13,197,89,286,59,26,20,29,33,15,8,1,24,0,,
4385,12,203,87,290,65,22,24,33,29,13,12,3,28,0,,
4386,6,195,65,260,37,9,16,28,26,11,9,3,23,0,,
4386,15,200,60,260,52,25,12,26,28,15,9,1,25,0,,
4387,1,218,148,366,71,21,20,17,21,15,6,0,21,0,,
4387,2,173,141,314,60,42,18,20,18,12,9,1,22,0,,
4388,4,211,118,329,61,27,34,24,25,16,9,0,25,0,,
4388,8,218,105,323,53,22,46,25,24,12,9,1,22,0,,
4389,12,184,106,290,66,30,28,22,21,24,12,2,38,0,,
4389,9,182,105,287,58,20,11,21,22,11,21,2,34,0,,
4390,14,190,102,292,60,29,13,23,27,12,14,2,28,0,,
4390,5,215,93,308,70,20,27,27,23,14,12,3,29,0,,
4391,3,220,93,313,73,14,26,24,21,18,13,3,34,0,,
4391,15,207,78,285,60,26,20,21,24,13,14,2,29,0,,
4392,2,198,120,318,73,29,16,30,24,18,16,4,38,0,,
4392,7,175,95,270,64,22,27,24,30,16,10,2,28,0,,
4393,10,190,119,309,60,16,14,25,33,10,9,2,21,0,,
4393,6,197,79,276,60,31,18,33,25,17,12,2,31,0,,
4394,1,192,133,325,63,15,3,29,20,10,7,1,18,0,,
4394,13,210,96,306,78,32,24,20,29,15,10,1,26,0,,
4395,12,205,122,327,63,40,22,14,15,18,14,1,33,0,,
4395,14,194,103,297,47,21,11,15,14,13,23,3,39,0,,
4396,13,201,97,298,57,18,22,22,21,14,13,2,29,0,,
4396,7,191,143,334,74,23,22,21,22,20,11,1,32,0,,
4397,9,219,124,343,92,23,10,20,16,7,12,1,20,0,,
4397,3,227,124,351,99,16,14,16,20,15,17,2,34,0,,
4398,5,249,132,381,80,30,18,28,20,14,15,2,31,0,,
4398,2,193,102,295,59,19,11,20,28,5,9,3,17,0,,
4399,8,191,127,318,65,14,20,26,21,10,12,1,23,0,,
4399,1,209,134,343,75,16,12,21,26,14,6,1,21,0,,
4400,15,204,107,311,58,34,29,21,18,18,21,2,41,0,,
4400,10,158,96,254,45,17,30,18,21,5,9,2,16,0,,
4401,4,214,126,340,79,21,36,21,17,20,8,0,28,0,,
4401,6,213,117,330,58,17,34,17,24,13,11,2,26,0,,
4402,2,216,130,346,72,38,18,17,19,22,19,2,43,0,,
4402,9,174,134,308,66,16,7,19,17,10,11,0,21,0,,
4403,5,211,123,334,80,21,25,26,17,15,10,2,27,0,,
4403,4,184,105,289,58,20,17,17,26,11,8,2,21,0,,
4404,6,190,77,267,57,24,11,21,18,9,6,1,16,0,,
4404,3,245,129,374,88,27,19,18,21,20,23,1,44,0,,
4405,7,209,126,335,67,24,26,19,18,11,11,1,23,0,,
4405,1,216,148,364,78,23,12,18,18,12,11,2,25,0,,
4406,8,227,106,333,85,32,20,30,25,18,8,2,28,0,,
4406,14,167,90,257,57,11,21,25,30,7,6,2,15,0,,
4407,13,175,81,256,56,31,29,23,24,10,8,5,23,0,,
4407,15,189,114,303,67,22,22,24,23,31,13,1,45,0,,
4408,10,179,91,270,41,27,9,29,22,13,11,1,25,0,,
4408,12,221,105,326,93,21,37,22,29,25,9,3,37,0,,
4409,4,187,104,291,49,22,47,30,32,16,12,0,28,0,,
4409,7,197,107,304,64,12,40,32,30,14,2,4,20,0,,
4410,5,222,119,341,77,33,19,31,22,17,10,1,28,0,,
4410,12,179,78,257,47,15,18,22,31,8,10,1,19,0,,
4411,8,180,81,261,54,28,13,22,23,10,5,2,17,0,,
4411,3,246,135,381,105,30,19,23,22,21,14,2,37,0,,
4412,1,196,109,305,65,19,15,24,24,17,9,1,27,0,,
4412,10,193,95,288,57,18,24,24,24,13,17,1,31,0,,
4413,14,218,113,331,59,24,24,30,32,17,11,0,28,0,,
4413,13,206,98,304,48,29,23,32,30,15,9,4,28,0,,
4414,15,188,114,302,64,30,16,33,28,22,10,2,34,0,,
4414,2,181,120,301,62,21,14,29,32,15,8,2,25,0,,
4415,9,227,177,404,84,28,13,16,25,17,9,0,26,0,,
4415,6,182,76,258,54,24,22,25,16,9,5,3,17,0,,
4416,4,195,149,344,75,35,21,16,17,16,12,1,29,0,,
4416,1,182,138,320,62,21,14,18,17,9,10,2,21,0,,
4417,12,232,77,309,68,38,27,30,14,19,8,1,28,0,,
4417,7,204,116,320,71,14,10,14,30,15,16,2,33,0,,
4418,3,192,73,265,67,23,19,34,25,15,15,1,31,0,,
4418,13,201,89,290,64,38,25,25,34,17,9,3,29,0,,
4419,6,209,146,355,64,30,18,25,21,17,3,3,23,0,,
4419,14,207,135,342,57,21,24,21,25,12,7,2,21,0,,
4420,2,159,151,310,53,13,20,21,31,10,6,2,18,0,,
4420,8,233,94,327,78,24,16,31,21,25,6,3,34,0,,
4421,15,214,132,346,76,28,22,31,30,13,9,3,25,0,,
4421,9,202,145,347,63,17,14,30,31,7,11,1,19,0,,
4422,10,174,86,260,61,16,16,21,21,19,8,1,28,0,,
4422,5,219,123,342,89,21,28,21,21,21,15,6,42,0,,
4423,12,204,87,291,73,28,36,27,27,15,11,0,26,0,,
4423,4,216,87,303,64,24,9,27,27,20,9,3,32,0,,
4424,3,251,151,402,97,30,19,30,19,18,16,1,35,0,,
4424,2,184,113,297,57,16,17,19,30,6,10,0,16,0,,
4425,13,207,102,309,69,31,18,33,26,15,14,5,34,0,,
4425,6,208,97,305,63,21,15,26,33,12,17,1,30,0,,
4426,14,212,121,333,42,30,22,23,24,17,7,1,25,0,,
4426,15,209,61,270,53,39,24,24,23,20,10,1,31,0,,
4427,7,204,122,326,51,28,23,23,31,22,14,2,38,0,,
4427,10,174,109,283,41,19,16,31,23,10,10,3,23,0,,
4428,9,214,141,355,80,20,18,16,24,14,8,3,25,0,,
4428,8,229,113,342,76,32,36,24,16,16,12,2,30,0,,
4429,1,209,131,340,82,17,8,21,14,14,11,1,26,0,,
4429,5,198,133,331,85,23,23,14,21,12,20,1,33,0,,
4430,15,191,74,265,50,23,21,30,21,14,13,1,28,0,,
4430,8,216,75,291,83,35,27,21,30,15,14,4,33,0,,
4431,13,213,102,315,55,16,19,19,24,10,10,3,23,0,,
4431,9,223,198,421,94,17,6,24,19,9,5,1,15,0,,
4432,5,262,160,422,118,25,23,27,27,16,20,1,37,0,,
4432,7,191,92,283,64,17,13,27,27,7,7,0,14,0,,
4433,14,199,104,303,56,19,15,27,26,14,8,0,22,0,,
4433,3,189,75,264,65,24,26,26,27,13,12,4,29,0,,
4434,6,202,83,285,68,16,15,25,29,16,16,1,33,0,,
4434,2,160,67,227,52,22,13,29,25,10,14,1,25,0,,
4435,1,212,154,366,43,28,10,21,23,9,12,1,22,0,,
4435,12,219,76,295,77,31,19,23,21,15,6,0,21,0,,
4436,10,186,97,283,54,19,20,27,21,10,8,0,18,0,,
4436,4,198,94,292,63,22,15,21,27,12,5,6,23,0,,
4437,6,193,107,300,46,33,16,22,23,12,14,2,28,0,,
4437,1,213,160,373,67,20,13,23,22,17,19,2,38,0,,
4438,8,234,124,358,91,14,13,24,22,17,14,3,34,0,,
4438,7,196,91,287,70,29,22,22,24,13,4,1,18,0,,
4439,13,220,119,339,91,28,25,23,26,27,8,3,38,0,,
4439,10,187,125,312,50,22,16,26,23,15,15,1,31,0,,
4440,9,219,137,356,82,16,18,22,32,25,12,1,38,0,,
4440,14,206,102,308,73,17,15,25,22,14,11,2,27,0,,
4441,15,216,97,313,44,26,12,19,24,13,8,3,24,0,,
4441,12,188,84,272,50,32,28,24,19,7,13,0,20,0,,
4442,3,210,79,289,67,22,17,27,23,13,5,1,19,0,,
4442,5,204,108,312,55,26,17,23,27,11,10,2,23,0,,
4443,4,211,122,333,67,20,21,25,12,22,19,2,43,0,,
4443,2,171,83,254,68,31,24,12,25,16,9,0,25,0,,
4444,10,198,137,335,61,23,18,19,25,11,16,4,31,0,,
4444,9,185,141,326,78,30,20,25,19,7,9,4,20,0,,
4445,12,212,72,284,73,31,19,26,26,16,9,2,27,0,,
4445,3,182,94,276,55,18,16,26,26,12,11,4,27,0,,
4446,8,236,108,344,84,26,12,21,17,26,6,1,33,0,,
4446,5,211,120,331,84,15,22,17,21,12,6,2,20,0,,
4447,7,214,124,338,62,30,25,22,22,17,11,4,32,0,,
4447,6,220,152,372,67,20,12,22,22,18,8,0,26,0,,
4448,1,235,137,372,98,22,13,21,23,12,15,1,28,0,,
4448,15,210,88,298,53,23,24,23,21,17,12,1,30,0,,
4449,2,189,103,292,75,26,17,23,33,14,8,2,24,0,,
4449,14,226,175,401,79,22,14,33,23,24,11,3,38,0,,
4450,4,195,99,294,68,13,16,27,19,15,11,2,28,0,,
4450,13,205,94,299,65,29,23,19,27,21,12,1,34,0,,
4451,15,222,112,334,60,35,24,25,24,27,15,2,44,0,,
4451,7,185,111,296,58,23,28,24,25,12,12,3,27,0,,
4452,8,232,106,338,102,30,17,32,29,17,13,1,31,0,,
4452,12,227,85,312,67,21,22,29,32,12,10,3,25,0,,
4453,5,223,107,330,77,18,15,27,25,17,13,3,33,0,,
4453,6,184,96,280,52,19,9,25,27,4,6,2,12,0,,
4454,3,209,73,282,69,16,26,28,30,15,12,2,29,0,,
4454,1,205,120,325,64,15,8,30,28,11,14,0,25,0,,
4455,14,219,135,354,76,19,21,26,33,12,15,3,30,0,,
4455,10,193,110,303,48,36,17,33,26,14,7,1,22,0,,
4456,2,192,102,294,57,18,12,28,42,7,7,1,15,0,,
4456,13,229,67,296,68,31,14,42,28,12,11,3,26,0,,
4457,9,205,132,337,80,21,24,18,28,8,5,6,19,0,,
4457,4,239,122,361,84,17,12,28,19,14,15,1,30,0,,
4458,1,232,191,423,87,13,12,22,17,16,19,2,37,0,,
4458,9,196,138,334,75,18,6,17,22,15,5,1,21,0,,
4459,6,218,140,358,76,29,8,27,22,18,15,2,35,0,,
4459,12,219,111,330,80,27,21,22,27,16,16,1,33,0,,
4460,15,187,82,269,46,16,16,23,21,8,14,5,27,0,,
4460,5,237,116,353,97,31,28,21,23,23,16,2,41,0,,
4461,7,185,101,286,77,25,13,25,16,13,14,1,28,0,,
4461,3,201,128,329,93,26,11,16,25,19,13,1,33,0,,
4462,14,202,126,328,66,27,18,25,25,12,10,1,23,0,,
4462,4,188,91,279,57,33,30,25,25,14,5,1,20,0,,
4463,13,212,93,305,72,13,22,22,26,17,12,2,31,0,,
4463,8,227,110,337,74,30,17,26,22,15,12,2,29,0,,
4464,10,198,151,349,65,18,16,16,19,15,19,0,34,0,,
4464,2,215,133,348,97,26,22,19,16,20,16,3,39,0,,
4465,5,228,142,370,88,32,22,19,16,13,12,0,25,0,,
4465,4,199,87,286,73,46,18,16,19,13,12,0,25,0,,
4466,13,197,63,260,79,32,20,27,35,10,12,1,23,0,,
4466,8,194,93,287,73,35,10,35,27,8,11,5,24,0,,
4467,5,196,116,312,76,36,12,16,28,19,10,2,31,0,,
4467,4,172,95,267,56,30,22,28,16,9,10,3,22,0,,
4468,4,218,118,336,80,34,15,24,29,19,15,1,35,0,,
4468,13,183,61,244,70,25,17,29,24,15,9,1,25,0,,
4469,5,215,98,313,74,47,19,28,23,17,14,1,32,0,,
4469,3,179,84,263,68,29,20,23,28,7,10,2,19,0,,
4470,3,233,90,323,97,43,17,26,27,18,11,2,31,0,,
4470,4,194,73,267,74,38,11,27,26,8,9,1,18,0,,
4471,5,221,93,314,64,52,16,20,27,13,10,1,24,0,,
4471,3,190,54,244,59,27,22,27,20,5,9,2,16,0,,
4472,4,188,60,248,62,15,32,24,31,14,10,2,26,0,,
4472,3,200,82,282,73,16,37,31,24,17,7,3,27,0,,
4473,7,222,104,326,72,25,16,32,30,20,14,2,36,0,,
4473,9,215,99,314,98,10,16,30,32,15,6,1,22,0,,
4474,12,188,92,280,54,37,26,34,36,10,11,2,23,0,,
4474,1,242,133,375,72,27,12,39,36,19,15,3,37,0,,
4475,5,217,93,310,86,29,15,33,30,13,14,1,28,0,,
4475,8,212,112,324,83,17,11,30,33,11,16,1,28,0,,
4476,13,195,67,262,73,18,52,32,33,18,5,3,26,0,,
4476,6,205,88,293,69,19,11,33,32,16,15,0,31,0,,
4477,15,203,73,276,49,24,19,22,21,18,15,2,35,0,,
4477,14,200,105,305,49,26,20,21,22,17,16,5,38,0,,
4478,10,197,65,262,41,15,12,42,53,12,14,3,29,0,,
4478,2,183,55,238,34,23,16,53,42,11,7,0,18,0,,
4480,6,242,120,362,76,20,16,38,34,20,12,0,32,0,,
4480,5,216,100,316,68,23,27,34,38,16,10,1,27,0,,
4481,3,208,79,287,75,13,15,40,28,14,8,2,24,0,,
4481,13,188,51,239,68,19,22,28,40,9,12,2,23,0,,
4482,2,231,124,355,97,15,16,31,30,24,10,2,36,0,,
4482,1,195,125,320,70,23,7,30,31,13,7,3,23,0,,
4483,15,195,78,273,50,17,11,28,22,11,5,1,17,0,,
4483,8,250,149,399,79,30,20,22,28,21,15,0,36,0,,
4484,9,239,127,366,71,23,15,38,28,18,12,3,33,0,,
4484,10,198,82,280,75,11,11,28,38,8,12,5,25,0,,
4485,14,205,137,342,54,19,30,40,40,26,17,2,45,0,,
4485,4,200,81,281,83,18,16,40,40,11,11,3,25,0,,
4486,5,238,146,384,73,26,17,34,21,19,19,2,40,0,,
4486,9,180,80,260,58,17,23,21,34,11,8,1,20,0,,
4487,8,223,113,336,77,35,19,31,33,20,11,4,35,0,,
4487,3,203,93,296,69,15,15,33,31,13,10,3,26,0,,
4488,7,187,79,266,63,22,23,34,28,19,8,0,27,0,,
4488,6,228,84,312,78,44,23,30,39,19,18,0,37,0,,
4489,1,204,102,306,63,25,9,30,23,8,16,2,26,0,,
4489,15,192,61,253,45,24,26,23,30,12,9,3,24,0,,
4490,2,191,108,299,60,24,25,34,30,8,11,2,21,0,,
4490,13,216,86,302,77,14,22,30,34,18,9,5,32,0,,
4491,14,237,122,359,84,27,22,27,34,16,17,4,37,0,,
4491,12,186,88,274,68,24,23,34,27,9,8,2,19,0,,
4492,10,207,150,357,69,18,19,26,23,20,13,1,34,0,,
4492,4,224,79,303,101,28,14,23,26,11,15,2,28,0,,
4493,13,228,74,302,96,15,20,37,32,11,12,1,24,0,,
4493,9,206,87,293,70,25,6,32,37,7,10,1,18,0,,
4494,5,224,150,374,97,23,23,15,27,23,20,1,44,0,,
4494,7,174,93,267,48,17,19,27,15,14,8,3,25,0,,
4495,6,201,75,276,66,25,21,37,24,11,12,1,24,0,,
4495,10,219,136,355,80,15,14,24,37,23,13,2,38,0,,
4496,1,186,111,297,47,42,12,46,26,12,14,1,27,0,,
4496,14,200,110,310,65,25,25,26,45,14,11,4,29,0,,
4497,4,195,63,258,53,13,55,31,18,10,10,2,22,0,,
4497,15,226,78,304,68,14,22,18,31,18,4,3,25,0,,
4498,12,212,95,307,67,38,2,40,34,15,14,6,35,0,,
4498,3,216,111,327,73,29,23,34,40,21,9,3,33,0,,
4499,2,208,120,328,92,24,17,27,31,9,11,1,21,0,,
4499,8,248,132,380,95,42,13,38,27,15,17,3,35,0,,
4500,8,213,106,319,68,24,23,34,37,18,16,1,35,0,,
4500,12,175,53,228,51,30,17,37,34,10,10,1,21,0,,
4501,3,208,134,342,75,26,28,33,32,20,16,2,38,0,,
4501,7,196,89,285,68,16,16,32,33,12,12,0,24,0,,
4502,6,227,62,289,71,42,15,32,23,16,15,2,33,0,,
4502,14,201,103,304,57,29,28,23,32,16,13,3,32,0,,
4503,13,220,88,308,82,26,25,35,27,11,14,2,27,0,,
4503,1,203,105,308,47,34,10,27,35,10,10,1,21,0,,
4504,9,236,100,336,82,23,16,44,29,10,13,0,23,0,,
4504,4,257,69,326,114,27,13,29,44,19,10,1,30,0,,
4505,10,201,91,292,61,28,19,26,40,10,12,5,27,0,,
4505,5,199,85,284,67,23,12,40,26,9,9,3,21,0,,
4506,15,198,90,288,49,21,16,26,25,20,11,3,34,0,,
4506,2,227,125,352,85,26,21,25,26,26,13,2,41,0,,
4507,4,194,85,279,70,13,42,31,24,12,7,2,21,0,,
4507,6,209,71,280,53,12,20,24,31,12,11,6,29,0,,
4508,12,224,92,316,82,36,17,30,20,15,11,1,27,0,,
4508,2,168,138,306,68,15,17,20,30,9,7,5,21,0,,
4509,13,191,88,279,54,17,32,36,32,9,10,0,19,0,,
4509,5,224,121,345,77,19,17,32,36,18,15,1,34,0,,
4510,8,214,104,318,70,31,20,22,9,26,12,3,41,0,,
4510,14,182,125,307,54,29,14,9,22,25,12,1,38,0,,
4511,7,211,104,315,75,26,15,39,37,13,15,2,30,0,,
4511,10,186,112,298,53,27,18,39,36,9,12,1,22,0,,
4512,9,217,87,304,72,23,20,31,34,8,8,3,19,0,,
4512,1,205,74,279,52,11,9,34,31,6,12,3,21,0,,
4513,15,195,71,266,57,35,10,25,29,17,17,2,36,0,,
4513,3,183,97,280,63,27,33,29,25,16,9,0,25,0,,
4514,10,185,94,279,52,23,24,29,28,7,14,2,23,0,,
4514,15,194,61,255,51,32,16,27,27,9,10,3,22,0,,
4515,13,204,98,302,65,21,28,27,25,12,14,0,26,0,,
4515,12,213,90,303,72,32,15,25,27,11,10,4,25,0,,
4516,5,231,123,354,100,32,18,27,27,16,10,0,26,0,,
4516,1,198,110,308,57,27,8,27,27,11,11,1,23,0,,
4517,8,251,117,368,86,23,29,26,36,25,13,2,40,0,,
4517,6,201,71,272,72,21,8,36,26,13,5,1,19,0,,
4518,14,226,158,384,70,25,27,21,19,35,14,4,53,0,,
4518,7,172,105,277,60,21,18,19,21,16,11,2,29,0,,
4519,2,206,116,322,85,12,16,40,16,13,10,4,27,0,,
4519,4,216,76,292,82,26,12,16,40,13,10,2,25,0,,
4520,9,204,108,312,76,26,25,23,19,12,7,2,21,0,,
4520,3,201,97,298,85,22,17,19,23,17,10,0,27,0,,
4521,14,228,155,383,60,26,24,26,18,26,20,3,49,0,,
4521,9,154,79,233,58,37,25,18,26,6,12,2,20,0,,
4522,12,185,109,294,52,33,24,27,24,12,7,1,20,0,,
4522,5,196,163,359,67,22,14,24,27,16,12,1,29,0,,
4523,3,210,97,307,71,21,23,27,32,21,18,1,40,0,,
4523,2,174,75,249,47,21,16,32,27,12,12,3,27,0,,
4524,1,217,112,329,73,24,12,26,24,8,14,2,24,0,,
4524,6,187,71,258,51,22,6,24,26,9,7,2,18,0,,
4525,8,229,124,353,82,17,30,25,21,22,21,4,47,0,,
4525,10,168,69,237,56,13,12,21,25,12,10,1,23,0,,
4526,7,192,119,311,63,23,33,31,29,18,6,1,25,0,,
4526,15,196,111,307,51,21,20,29,31,17,8,2,27,0,,
4527,4,236,88,324,97,13,27,24,24,12,20,1,33,0,,
4527,13,217,77,294,63,18,21,25,24,13,15,2,30,0,,
4528,15,208,121,329,55,27,18,23,17,25,13,2,40,0,,
4528,9,187,104,291,67,25,31,17,23,10,8,3,21,0,,
4529,12,228,89,317,72,28,23,27,20,24,11,4,39,0,,
4529,6,205,71,276,70,24,4,20,27,18,13,1,32,0,,
4530,3,195,130,325,72,30,18,23,30,19,10,1,30,0,,
4530,5,209,120,329,83,28,15,30,23,7,14,2,23,0,,
4531,2,187,99,286,64,17,11,31,30,10,16,1,27,0,,
4531,14,244,126,370,103,23,14,30,31,32,14,5,51,0,,
4532,7,218,143,361,81,25,37,27,18,18,10,0,28,0,,
4532,4,205,78,283,76,15,12,18,27,12,8,3,23,0,,
4533,1,197,99,296,64,28,17,35,19,10,10,3,23,0,,
4533,8,214,91,305,74,37,29,19,35,17,14,1,32,0,,
4534,10,192,100,292,74,28,15,29,34,6,7,0,13,0,,
4534,13,217,55,272,69,15,7,34,29,6,12,4,22,0,,
4535,15,187,84,271,40,23,21,21,32,12,11,0,23,0,,
4535,13,211,98,309,65,25,27,32,21,16,15,2,33,0,,
4536,12,203,113,316,82,35,22,18,22,17,12,1,30,0,,
4536,9,203,60,263,68,21,12,22,18,18,8,2,28,0,,
4537,5,181,114,295,60,33,24,33,19,13,8,2,23,0,,
4537,14,210,119,329,80,41,25,19,33,23,12,4,39,0,,
4538,3,208,137,345,79,26,15,23,19,18,14,0,32,0,,
4538,6,215,67,282,69,33,14,19,23,10,9,0,19,0,,
4539,1,218,85,303,64,20,12,36,29,14,13,1,28,0,,
4539,10,193,92,285,58,26,16,29,36,10,5,1,16,0,,
4540,7,233,120,353,89,26,21,27,20,13,17,4,34,0,,
4540,2,211,111,322,94,12,17,20,27,13,12,2,27,0,,
4541,4,212,95,307,84,16,26,18,25,15,12,3,30,0,,
4541,8,224,91,315,80,13,43,26,18,16,13,1,30,0,,
4542,10,166,78,244,58,21,11,35,35,8,7,2,17,0,,
4542,12,183,56,239,51,24,21,35,35,12,13,0,25,0,,
4543,2,199,43,242,42,12,10,37,33,5,11,4,20,0,,
4543,9,173,58,231,35,37,17,33,37,3,8,0,11,0,,
4544,6,208,65,273,40,32,16,37,32,1,6,2,9,0,,
4544,15,202,41,243,44,18,7,32,37,6,9,4,19,0,,
4545,1,225,72,297,55,17,29,23,40,9,7,1,17,0,,
4545,7,231,78,309,58,21,15,40,23,7,11,1,19,0,,
4546,4,197,117,314,81,15,34,22,24,11,10,5,26,0,,
4546,5,214,155,369,69,17,25,24,22,17,10,4,31,0,,
4547,14,230,74,304,59,38,18,32,49,12,14,3,29,0,,
4547,3,202,57,259,47,33,23,49,32,4,7,4,15,0,,
4548,8,198,62,260,37,25,15,33,30,8,5,1,14,0,,
4548,13,206,65,271,48,26,21,30,33,10,7,2,19,0,,
4549,4,213,102,315,81,19,40,22,30,16,8,1,25,0,,
4549,1,243,114,357,72,15,28,30,22,11,9,2,22,0,,
4550,12,200,61,261,47,26,26,32,29,7,5,4,16,0,,
4550,15,189,77,266,41,41,11,29,32,5,5,5,15,0,,
4551,5,221,173,394,79,29,17,27,26,18,14,1,33,0,,
4551,2,203,115,318,85,18,17,26,27,9,12,3,24,0,,
4552,3,186,65,251,55,33,30,32,31,7,6,2,15,0,,
4552,10,199,72,271,52,21,15,31,32,7,12,1,20,0,,
4553,13,229,62,291,68,26,16,39,22,2,6,2,10,0,,
4553,14,236,97,333,56,34,25,22,39,13,7,4,24,0,,
4554,7,205,86,291,42,26,19,46,26,8,5,1,14,0,,
4554,8,231,122,353,71,44,25,26,46,10,8,4,22,0,,
4555,9,210,112,322,66,26,27,27,29,18,6,0,24,0,,
4555,6,213,99,312,86,22,10,29,27,19,12,2,33,0,,
4556,8,249,126,375,78,20,11,27,29,15,16,0,31,0,,
4556,9,189,64,253,51,32,25,29,27,4,8,3,15,0,,
4557,12,199,52,251,53,24,21,42,29,9,6,4,19,0,,
4557,4,209,42,251,63,30,11,29,42,5,9,2,16,0,,
4558,5,208,109,317,55,29,22,30,24,14,23,1,38,0,,
4558,15,179,90,269,43,15,16,24,30,8,8,0,16,0,,
4559,3,201,68,269,41,27,24,30,32,3,10,0,13,0,,
4559,1,186,49,235,56,17,5,32,30,3,2,3,8,0,,
4560,6,218,94,312,80,33,12,24,33,15,4,1,20,0,,
4560,2,186,105,291,60,21,17,33,24,9,10,3,22,0,,
4561,7,221,67,288,66,15,12,44,40,8,6,2,16,0,,
4561,13,227,76,303,61,15,24,39,44,10,3,1,14,0,,
4562,10,223,118,341,74,26,13,23,14,14,14,5,33,0,,
4562,14,185,109,294,73,21,13,14,23,16,14,1,31,0,,
4563,15,228,143,371,56,30,19,19,29,18,17,2,37,0,,
4563,7,200,100,300,54,18,18,29,19,9,11,2,22,0,,
4564,3,195,108,303,66,30,25,29,30,9,6,1,16,0,,
4564,12,197,72,269,49,30,22,30,29,8,10,0,18,0,,
4565,14,207,94,301,71,34,22,30,33,11,12,4,27,0,,
4565,6,185,94,279,50,23,12,33,30,8,6,4,18,0,,
4566,8,253,122,375,107,13,10,26,25,19,24,3,46,0,,
4566,4,179,111,290,68,20,16,23,28,6,10,4,20,0,,
4567,2,185,95,280,59,15,20,26,25,10,12,3,25,0,,
4567,10,172,91,263,41,24,29,25,26,7,5,3,15,0,,
4568,9,220,128,348,87,22,15,18,22,14,13,2,29,0,,
4568,13,221,112,333,79,18,23,22,18,17,10,1,28,0,,
4569,1,211,123,334,65,32,23,29,19,15,11,4,30,0,,
4569,5,181,113,294,77,31,25,19,29,7,14,1,22,0,,
4570,5,197,143,340,76,31,16,32,37,12,17,1,30,0,,
4570,12,192,82,274,60,31,20,37,32,15,4,2,21,0,,
4571,3,248,128,376,95,21,19,39,26,25,8,2,35,0,,
4571,4,189,79,268,58,33,16,26,39,1,10,2,13,0,,
4572,6,242,127,369,71,26,8,35,28,12,18,2,32,0,,
4572,7,218,98,316,80,22,25,28,35,13,6,2,21,0,,
4573,13,218,107,325,79,25,26,22,19,17,14,1,32,0,,
4573,15,202,114,316,57,18,12,19,22,11,11,4,26,0,,
4574,9,203,99,302,77,26,17,30,28,11,11,0,22,0,,
4574,14,226,100,326,86,17,21,28,30,22,15,4,41,0,,
4575,10,233,89,322,78,23,19,28,32,16,16,5,37,0,,
4575,1,208,122,330,76,25,15,32,28,10,13,4,27,0,,
4576,2,162,83,245,56,13,15,33,32,15,13,1,29,0,,
4576,8,205,96,301,86,16,15,32,33,22,7,3,32,0,,
4577,1,213,113,326,64,22,5,35,28,6,8,2,16,0,,
4577,12,226,103,329,77,31,24,28,35,6,7,3,16,0,,
4578,8,212,114,326,78,30,22,22,32,21,9,2,32,0,,
4578,5,180,120,300,71,16,18,32,22,11,9,2,22,0,,
4579,2,195,78,273,62,20,11,26,32,9,11,1,21,0,,
4579,3,214,101,315,83,29,20,32,26,14,13,2,29,0,,
4580,14,205,101,306,82,34,14,21,29,17,4,3,24,0,,
4580,13,209,114,323,75,30,36,29,21,16,14,2,32,0,,
4581,9,237,119,356,108,20,9,24,25,14,8,2,24,0,,
4581,7,200,121,321,77,23,15,25,24,12,17,1,30,0,,
4582,15,185,104,289,59,15,21,24,22,8,15,3,26,0,,
4582,6,228,94,322,67,41,18,22,24,16,8,3,27,0,,
4583,4,213,111,324,76,15,37,28,35,16,15,1,32,0,,
4583,10,168,100,268,41,13,29,35,28,9,12,4,25,0,,
4584,2,180,78,258,59,14,11,28,30,6,13,2,21,0,,
4584,6,225,107,332,53,26,17,30,28,18,13,2,33,0,,
4585,12,207,77,284,70,41,21,24,21,15,16,0,31,0,,
4585,13,222,120,342,83,21,19,22,25,10,14,5,29,0,,
4586,14,196,107,303,75,25,22,22,28,14,15,5,34,0,,
4586,5,191,115,306,66,43,27,28,22,19,11,0,30,0,,
4587,7,211,114,325,82,18,15,34,25,16,9,1,26,0,,
4587,3,210,103,313,76,33,24,25,34,20,13,0,33,0,,
4588,15,194,97,291,72,22,11,17,21,9,21,3,33,0,,
4588,8,230,158,388,91,32,17,21,17,23,13,3,39,0,,
4589,10,194,156,350,60,20,19,23,26,12,19,4,35,0,,
4589,9,201,109,310,72,27,22,26,23,9,12,4,25,0,,
4590,1,213,85,298,59,20,10,41,18,10,10,2,22,0,,
4590,4,215,121,336,84,32,20,18,41,16,12,1,29,0,,
4591,12,196,112,308,69,29,27,25,29,14,3,3,20,0,,
4591,8,197,96,293,58,32,13,29,25,14,10,1,25,0,,
4592,5,176,126,302,62,26,25,32,39,11,13,2,26,0,,
4592,10,173,98,271,41,33,22,39,32,12,9,4,25,0,,
4593,6,213,113,326,66,28,12,12,22,23,13,0,36,0,,
4593,13,193,126,319,68,23,39,22,12,15,9,4,28,0,,
4594,7,202,106,308,64,26,16,43,28,13,10,2,25,0,,
4594,14,206,142,348,72,24,17,28,43,17,9,2,28,0,,
4595,9,250,91,341,81,12,12,26,15,25,11,6,42,0,,
4595,15,163,130,293,57,17,12,15,26,12,11,1,24,0,,
4596,1,210,81,291,73,34,10,38,37,3,4,1,8,0,,
4596,3,237,93,330,77,27,22,37,38,7,8,1,16,0,,
4597,4,217,137,354,77,19,20,33,40,19,16,0,35,0,,
4597,2,196,105,301,61,23,24,40,33,10,18,1,29,0,,
4598,2,185,62,247,57,19,7,35,36,11,6,4,21,0,,
4598,12,197,93,290,75,32,18,36,35,15,13,1,29,0,,
4599,3,266,144,410,119,28,19,34,22,15,11,0,26,0,,
4599,9,212,90,302,72,14,8,22,34,7,5,0,12,0,,
4600,6,224,102,326,80,20,11,34,35,11,5,1,17,0,,
4600,4,204,95,299,58,32,34,35,34,5,9,1,15,0,,
4601,14,223,110,333,73,25,20,22,25,18,16,0,34,0,,
4601,1,206,83,289,68,19,9,25,22,10,13,1,24,0,,
4602,13,214,83,297,78,16,23,25,37,9,8,1,18,0,,
4602,8,251,100,351,98,23,9,37,25,12,15,0,27,0,,
4603,15,178,109,287,56,33,9,21,34,11,12,2,25,0,,
4603,5,195,97,292,56,28,27,34,21,11,11,1,23,0,,
4604,10,183,118,301,47,31,23,23,23,25,8,1,34,0,,
4604,7,203,97,300,68,32,20,23,23,16,9,4,29,0,,
4605,4,218,104,322,79,24,22,33,26,18,18,0,36,0,,
4605,14,177,99,276,52,10,28,26,33,12,8,2,22,0,,
4606,12,234,91,325,91,36,35,19,27,20,10,3,33,0,,
4606,7,231,122,353,81,16,10,27,19,20,11,1,32,0,,
4607,6,182,101,283,51,27,10,17,22,10,10,1,21,0,,
4607,5,222,134,356,73,38,23,22,17,14,18,2,34,0,,
4608,3,194,101,295,59,30,33,28,29,19,13,1,33,0,,
4608,15,174,92,266,46,21,11,29,28,17,9,1,27,0,,
4609,1,245,120,365,103,27,10,34,37,15,13,4,32,0,,
4609,2,175,105,280,50,18,7,37,34,3,10,1,14,0,,
4610,13,192,115,307,77,26,40,27,25,14,10,4,28,0,,
4610,10,181,127,308,52,29,24,25,27,12,12,3,27,0,,
4611,9,232,101,333,99,19,24,31,30,12,5,0,17,0,,
4611,8,204,108,312,80,20,10,30,31,9,6,1,16,0,,
4612,10,177,140,317,52,28,14,22,25,15,19,1,35,0,,
4612,3,192,74,266,74,21,24,25,22,15,12,2,29,0,,
4613,6,186,94,280,50,24,10,18,22,10,6,2,18,0,,
4613,9,193,78,271,75,21,20,22,18,12,5,4,21,0,,
4614,5,216,114,330,58,28,25,32,37,12,10,1,23,0,,
4614,2,188,70,258,53,22,6,37,32,4,8,5,17,0,,
4615,8,252,111,363,96,22,21,20,26,19,17,3,39,0,,
4615,1,193,100,293,61,27,12,26,20,8,11,0,19,0,,
4616,14,211,120,331,70,40,29,19,20,20,15,4,39,0,,
4616,15,180,114,294,42,30,22,20,19,17,12,3,32,0,,
4617,13,215,95,310,73,25,25,36,37,10,7,5,22,0,,
4617,7,247,98,345,84,22,17,33,33,16,7,1,24,0,,
4618,4,233,106,339,90,18,19,29,28,21,21,1,43,0,,
4618,12,194,65,259,62,12,39,28,29,10,11,1,22,0,,
4619,15,180,125,305,44,30,13,17,28,13,14,1,28,0,,
4619,10,181,133,314,51,27,28,28,17,21,8,2,31,0,,
4620,5,197,118,315,54,18,30,26,20,20,9,0,29,0,,
4620,4,206,88,294,83,20,9,20,26,11,14,0,25,0,,
4621,13,199,117,316,67,24,26,26,26,13,8,3,24,0,,
4621,3,238,109,347,105,23,6,25,25,16,11,1,28,0,,
4622,6,223,101,324,81,30,17,22,23,13,17,1,31,0,,
4622,1,211,96,307,76,14,11,23,22,12,8,1,21,0,,
4623,14,234,157,391,92,25,21,25,37,23,24,0,47,0,,
4623,2,166,96,262,58,26,10,37,25,12,12,2,26,0,,
4624,8,259,161,420,105,26,29,12,18,28,12,1,41,0,,
4624,7,197,99,296,80,13,13,18,12,13,12,1,26,0,,
4625,9,247,114,361,110,24,4,23,23,15,15,0,30,0,,
4625,12,212,82,294,73,19,18,24,23,10,8,2,20,0,,
4626,13,219,87,306,67,38,28,35,20,17,7,2,26,0,,
4626,5,201,116,317,63,25,23,20,35,13,10,0,23,0,,
4627,3,216,89,305,72,32,32,21,22,24,13,0,37,0,,
4627,14,175,89,264,33,27,23,22,21,11,12,3,26,0,,
4628,8,212,83,295,66,50,25,34,26,16,14,2,32,0,,
4628,3,177,125,302,61,20,26,26,34,11,7,3,21,0,,
4629,14,226,100,326,95,30,22,22,33,22,20,1,43,0,,
4629,13,190,80,270,61,32,19,33,24,12,16,2,30,0,,
4630,14,216,96,312,76,51,25,34,31,24,19,1,44,0,,
4630,3,186,81,267,68,31,15,31,34,10,10,0,20,0,,
4631,8,175,60,235,61,47,19,26,24,21,17,1,39,0,,
4631,14,176,75,251,57,25,21,24,26,21,12,0,33,0,,
4632,12,202,77,279,76,16,20,19,26,18,17,1,36,0,,
4632,8,214,100,314,74,23,25,26,19,15,17,4,36,0,,
4633,3,228,117,345,71,17,30,29,28,25,11,3,39,0,,
4633,15,170,73,243,43,13,5,28,29,12,8,2,22,0,,
4634,14,200,116,316,78,19,19,21,26,11,13,4,28,0,,
4634,4,239,98,337,108,20,20,27,20,14,17,3,34,0,,
4635,9,222,72,294,62,16,19,28,21,10,12,3,25,0,,
4635,5,198,90,288,53,28,18,21,28,11,15,2,28,0,,
4636,6,213,108,321,52,33,20,22,28,20,15,5,40,0,,
4636,7,206,102,308,76,18,22,28,22,17,14,2,33,0,,
4637,1,220,91,311,74,29,19,29,26,16,4,2,22,0,,
4637,10,190,96,286,47,27,14,26,29,11,8,2,21,0,,
4638,2,163,103,266,57,23,13,28,30,16,10,2,28,0,,
4638,13,195,94,289,58,31,36,30,28,23,13,3,39,0,,
4639,4,244,123,367,84,24,21,23,28,26,15,4,45,0,,
4639,3,197,76,273,78,13,40,28,23,11,9,1,21,0,,
4640,12,214,88,302,82,24,17,24,20,19,12,3,34,0,,
4640,9,185,98,283,58,24,13,20,24,7,17,2,26,0,,
4641,5,203,134,337,79,28,23,24,22,15,10,2,27,0,,
4641,6,189,118,307,44,19,16,22,24,9,13,3,25,0,,
4642,1,182,80,262,67,27,10,31,27,9,10,2,21,0,,
4642,13,189,58,247,56,23,28,27,31,13,5,3,21,0,,
4643,15,205,57,262,51,15,5,25,26,20,5,2,27,0,,
4643,14,214,99,313,67,12,26,26,25,21,16,0,37,0,,
4644,8,221,127,348,93,26,16,22,24,26,14,1,41,0,,
4644,2,181,105,286,67,36,10,24,22,12,13,1,26,0,,
4645,10,216,83,299,53,29,23,36,35,9,11,1,21,0,,
4645,7,220,89,309,75,17,9,35,36,7,13,0,20,0,,
4646,3,187,73,260,59,23,19,30,35,11,13,0,24,0,,
4646,12,214,88,302,78,35,26,39,28,23,8,5,36,0,,
4647,2,182,124,306,55,25,14,28,22,12,8,0,20,0,,
4647,5,219,171,390,77,13,21,22,26,23,10,2,35,0,,
4648,1,208,94,302,66,25,16,31,26,16,9,3,28,0,,
4648,6,191,86,277,59,26,13,26,31,7,13,2,22,0,,
4649,13,204,80,284,66,36,20,31,34,9,15,3,27,0,,
4649,14,203,102,305,71,29,18,33,33,9,10,0,19,0,,
4650,8,208,101,309,64,25,24,29,28,17,10,2,29,0,,
4650,10,194,118,312,51,14,7,28,29,13,12,3,28,0,,
4651,7,183,104,287,59,35,15,26,25,17,4,2,23,0,,
4651,15,197,76,273,49,20,17,25,26,11,14,2,27,0,,
4652,9,185,120,305,67,9,29,22,25,10,14,0,24,0,,
4652,4,247,88,335,104,17,27,22,22,29,17,1,47,0,,
4653,13,232,84,316,74,22,26,26,33,13,17,1,31,0,,
4653,9,205,127,332,77,20,8,33,26,5,10,1,16,0,,
4654,5,235,118,353,86,17,20,42,20,13,13,3,29,0,,
4654,4,158,99,257,44,27,16,20,42,8,4,3,15,0,,
4655,8,235,92,327,92,23,12,31,23,17,18,0,35,0,,
4655,6,183,95,278,60,27,22,23,31,15,14,2,31,0,,
4656,15,201,84,285,54,17,14,22,39,19,8,3,30,0,,
4656,1,175,76,251,47,15,11,39,22,13,9,0,22,0,,
4657,10,164,99,263,48,27,9,12,23,10,15,5,30,0,,
4657,12,247,125,372,89,25,31,23,12,24,22,0,46,0,,
4658,7,198,76,274,55,28,11,47,26,10,8,1,19,0,,
4658,3,209,81,290,59,20,20,26,45,14,7,0,21,0,,
4659,2,185,75,260,69,25,5,28,21,11,15,1,27,0,,
4659,14,206,137,343,73,22,24,21,28,24,11,6,41,0,,
4660,4,225,101,326,61,26,43,20,25,14,14,2,30,0,,
4660,1,196,75,271,60,19,35,29,21,14,9,0,23,0,,
4661,7,197,79,276,69,27,21,27,27,12,10,2,24,0,,
4661,9,208,109,317,81,26,15,27,27,13,14,1,28,0,,
4662,12,198,102,300,77,18,20,25,37,10,8,1,19,0,,
4662,5,228,111,339,92,29,10,37,25,14,10,3,27,0,,
4663,14,207,92,299,85,29,18,25,18,17,13,1,31,0,,
4663,3,204,90,294,65,21,19,18,25,13,14,0,27,0,,
4664,6,204,108,312,80,30,19,20,15,12,16,3,31,0,,
4664,2,199,102,301,79,19,11,15,20,23,13,2,38,0,,
4665,15,183,83,266,58,12,7,13,9,19,9,5,33,0,,
4665,8,220,122,342,75,15,23,9,13,31,18,1,50,0,,
4666,10,211,123,334,80,22,11,36,26,12,15,2,29,0,,
4666,13,227,75,302,77,23,20,26,36,17,12,2,31,0,,
4667,15,221,116,337,49,20,15,21,29,17,17,4,38,0,,
4667,4,198,64,262,51,25,17,29,21,17,7,1,25,0,,
4668,12,215,43,258,57,12,19,28,37,10,10,2,22,0,,
4668,7,225,81,306,57,20,3,37,28,4,7,1,12,0,,
4669,5,221,104,325,88,14,19,31,22,13,13,0,26,0,,
4669,8,205,85,290,82,31,27,22,31,14,9,0,23,0,,
4670,13,213,51,264,58,27,21,23,28,9,12,2,23,0,,
4670,3,228,74,302,71,40,22,28,23,16,4,1,21,0,,
4671,1,221,69,290,60,16,9,27,20,12,15,4,31,0,,
4671,2,186,60,246,45,18,8,20,30,5,14,2,21,0,,
4672,9,236,120,356,93,33,11,16,25,17,9,2,28,0,,
4672,6,219,108,327,89,28,17,25,16,16,13,2,31,0,,
4673,14,214,117,331,63,25,25,19,33,16,14,1,31,0,,
4673,10,196,90,286,74,30,14,33,19,17,11,1,29,0,,
4674,4,228,76,304,64,18,31,23,35,17,10,0,27,0,,
4674,7,209,94,303,61,14,21,35,23,3,15,3,21,0,,
4675,14,235,94,329,89,30,13,34,30,15,12,2,29,0,,
4675,12,219,107,326,69,16,20,30,32,14,9,0,23,0,,
4676,3,208,90,298,64,26,21,23,21,17,12,5,34,0,,
4676,5,161,116,277,51,27,10,21,23,11,9,0,20,0,,
4677,6,214,130,344,75,25,14,22,34,15,15,1,31,0,,
4677,10,210,107,317,79,13,14,34,22,9,10,3,22,0,,
4678,13,224,90,314,88,30,19,27,20,15,18,3,36,0,,
4678,8,213,110,323,89,15,10,20,27,13,9,3,25,0,,
4679,9,227,114,341,88,28,18,27,26,10,9,3,22,0,,
4679,1,199,95,294,72,19,19,26,27,9,17,0,26,0,,
4680,2,174,68,242,41,22,18,20,26,11,6,1,18,0,,
4680,15,223,47,270,41,19,17,26,20,22,16,2,40,0,,
4681,10,211,104,315,66,19,17,22,18,11,17,4,32,0,,
4681,9,212,121,333,68,38,29,17,22,17,12,1,30,0,,
4682,12,217,90,307,87,21,18,25,27,19,18,2,39,0,,
4682,15,195,61,256,52,33,24,27,25,19,7,0,26,0,,
4683,5,202,111,313,71,35,28,29,21,13,10,0,23,0,,
4683,1,202,92,294,69,12,5,21,29,11,11,5,27,0,,
4684,3,234,69,303,94,25,17,26,34,20,15,2,37,0,,
4684,2,172,63,235,50,11,8,34,26,13,7,4,24,0,,
4685,6,217,130,347,72,29,11,21,17,12,13,4,29,0,,
4685,13,253,97,350,106,20,16,17,21,17,11,2,30,0,,
4686,14,221,130,351,73,26,12,24,22,16,11,1,28,0,,
4686,7,207,126,333,78,29,23,22,24,17,10,2,29,0,,
4687,4,212,92,304,85,9,32,20,25,9,6,3,18,0,,
4687,8,250,112,362,95,23,27,25,20,17,13,1,31,0,,
4688,3,221,115,336,75,29,24,26,33,29,19,1,49,0,,
4688,9,168,73,241,51,22,12,32,27,8,6,0,14,0,,
4689,15,197,70,267,53,23,11,28,25,4,8,3,15,0,,
4689,5,214,114,328,71,23,18,24,29,11,13,4,28,0,,
4690,14,275,155,430,116,22,18,33,23,20,12,1,33,0,,
4690,6,199,164,363,92,24,16,23,33,15,8,2,25,0,,
4691,8,247,140,387,77,20,23,18,23,23,13,3,39,0,,
4691,1,192,82,274,66,12,9,23,18,9,10,1,20,0,,
4692,7,200,113,313,58,26,22,28,23,16,8,2,26,0,,
4692,13,209,78,287,37,19,14,23,28,11,10,2,23,0,,
4693,2,174,77,251,65,27,17,21,31,10,13,0,23,0,,
4693,10,199,114,313,62,21,20,31,21,20,16,0,36,0,,
4694,4,188,69,257,60,23,37,31,36,12,14,1,27,0,,
4694,12,221,88,309,81,20,24,36,31,15,10,0,25,0,,
4695,10,238,102,340,59,38,14,25,33,11,11,0,22,0,,
4695,3,194,91,285,52,11,11,33,25,8,5,2,15,0,,
4696,1,189,81,270,56,10,11,38,28,11,6,3,20,0,,
4696,12,191,82,273,69,23,26,28,38,15,6,0,21,0,,
4697,5,230,121,351,93,21,16,19,25,10,11,0,21,0,,
4697,13,213,103,316,77,19,28,25,19,12,10,2,24,0,,
4698,6,220,125,345,75,21,19,10,23,24,12,1,37,0,,
4698,15,214,96,310,67,32,25,23,10,18,12,4,34,0,,
4699,7,210,94,304,80,23,18,27,24,17,17,2,36,0,,
4699,8,199,95,294,68,26,22,24,27,21,10,1,32,0,,
4700,9,215,112,327,83,22,24,26,19,16,10,3,29,0,,
4700,14,220,115,335,74,14,16,19,26,24,13,5,42,0,,
4701,2,195,114,309,65,28,15,25,18,16,19,1,36,0,,
4701,4,187,63,250,59,21,27,18,25,10,13,2,25,0,,
4702,10,197,97,294,52,24,18,26,29,18,24,0,42,0,,
4702,15,175,88,263,46,27,12,29,26,19,9,2,30,0,,
4703,12,229,101,330,85,7,21,19,23,21,15,3,39,0,,
4703,6,200,110,310,66,25,11,23,19,15,11,0,26,0,,
4704,7,194,109,303,66,28,19,30,29,7,9,0,16,0,,
4704,1,218,97,315,62,14,16,29,30,11,12,0,23,0,,
4705,9,240,114,354,111,27,16,32,23,23,11,2,36,0,,
4705,2,180,101,281,65,17,16,23,32,15,11,2,28,0,,
4706,14,216,154,370,78,10,16,31,25,9,8,2,19,0,,
4706,5,227,146,373,87,36,25,24,33,16,7,0,23,0,,
4707,8,251,109,360,83,28,15,33,22,17,14,2,33,0,,
4707,3,197,101,298,65,28,14,21,33,10,7,1,18,0,,
4708,13,212,103,315,81,33,21,34,18,13,14,1,28,0,,
4708,4,212,106,318,81,27,17,18,34,10,10,3,23,0,,
4709,2,213,108,321,73,20,10,29,28,15,19,1,35,0,,
4709,12,208,80,288,73,7,15,29,29,12,17,4,33,0,,
4710,8,228,93,321,62,25,21,21,31,10,18,2,30,0,,
4710,9,196,65,261,48,18,20,31,22,2,5,0,7,0,,
4711,7,217,121,338,50,26,20,39,22,3,10,2,15,0,,
4711,5,241,93,334,50,25,31,22,39,7,9,0,16,0,,
4712,6,223,70,293,45,15,12,40,43,7,8,1,16,0,,
4712,3,201,53,254,53,25,15,43,40,4,8,1,13,0,,
4713,1,212,85,297,55,27,9,19,22,7,12,2,21,0,,
4713,14,207,86,293,56,17,17,22,19,3,11,1,15,0,,
4714,15,243,72,315,51,20,15,25,27,10,14,0,24,0,,
4714,13,217,68,285,43,21,21,27,27,7,17,2,26,0,,
4715,10,195,120,315,62,25,17,20,25,14,19,1,34,0,,
4715,4,190,72,262,60,16,10,25,20,8,8,5,21,0,,
4716,15,230,109,339,75,33,20,17,30,22,18,1,41,0,,
4716,9,194,99,293,55,40,17,30,17,13,7,0,20,0,,
4717,13,206,77,283,64,25,16,31,36,10,6,0,16,0,,
4717,12,200,83,283,61,20,14,36,31,5,11,2,18,0,,
4718,5,221,142,363,74,31,22,31,32,9,13,1,23,0,,
4718,10,171,97,268,48,21,26,32,31,2,11,0,13,0,,
4719,3,190,70,260,57,19,32,36,30,10,13,2,25,0,,
4719,1,188,82,270,57,23,6,30,36,15,8,1,24,0,,
4720,8,215,133,348,68,18,17,29,37,17,9,1,27,0,,
4720,14,202,111,313,55,24,23,36,28,12,10,5,27,0,,
4721,7,245,113,358,85,23,15,46,34,8,11,7,26,0,,
4721,2,195,122,317,77,21,10,34,46,5,10,1,16,0,,
4722,4,227,104,331,82,21,41,25,19,17,18,1,36,0,,
4722,6,190,125,315,76,16,25,18,25,13,8,1,22,0,,
4723,10,170,127,297,48,15,13,18,23,13,11,7,31,0,,
4723,2,202,113,315,65,23,20,23,21,19,16,1,36,0,,
4724,12,192,99,291,70,15,21,27,23,11,18,3,32,0,,
4724,5,216,105,321,94,20,16,24,27,16,13,1,30,0,,
4725,3,206,113,319,68,21,28,25,20,16,11,5,32,0,,
4725,4,199,86,285,60,25,13,20,25,13,6,1,20,0,,
4726,6,182,74,256,67,24,13,22,22,10,10,1,21,0,,
4726,15,237,119,356,82,23,13,22,22,15,18,2,35,0,,
4727,1,226,92,318,96,12,14,32,33,11,10,1,22,0,,
4727,8,225,139,364,78,21,21,33,32,15,13,2,30,0,,
4728,14,200,115,315,67,19,14,33,25,8,7,1,16,0,,
4728,13,224,99,323,102,24,22,25,33,13,9,2,24,0,,
4729,9,244,113,357,90,21,14,32,24,14,13,2,29,0,,
4729,7,214,101,315,90,22,15,24,32,12,13,4,29,0,,
4730,7,202,113,315,83,22,14,24,30,9,9,2,20,0,,
4730,12,206,98,304,61,18,15,30,24,10,7,2,19,0,,
4731,6,222,116,338,71,39,21,17,23,21,14,2,37,0,,
4731,5,200,125,325,71,18,33,23,17,7,9,1,17,0,,
4732,1,224,102,326,62,18,14,17,26,12,7,1,20,0,,
4732,2,200,95,295,54,22,12,26,17,8,7,0,15,0,,
4733,13,166,104,270,54,18,20,34,36,8,6,3,17,0,,
4733,10,209,89,298,73,26,25,36,34,19,15,1,35,0,,
4734,9,227,101,328,91,21,10,30,28,12,17,2,31,0,,
4734,8,219,108,327,83,30,22,28,30,17,7,6,30,0,,
4735,15,216,96,312,76,37,17,27,27,14,9,1,24,0,,
4735,3,228,136,364,72,10,21,27,27,21,11,3,35,0,,
4736,4,204,112,316,81,15,41,27,25,18,14,4,36,0,,
4736,14,185,116,301,54,16,18,25,27,16,6,4,26,0,,
4737,4,200,72,272,66,16,49,21,25,14,11,3,28,0,,
4737,9,204,98,302,63,24,18,25,21,12,12,5,29,0,,
4738,12,213,118,331,87,25,21,22,22,21,15,0,36,0,,
4738,14,207,103,310,57,28,15,22,22,14,12,2,28,0,,
4739,13,214,88,302,78,31,21,27,26,14,10,0,24,0,,
4739,5,205,126,331,82,32,18,26,27,6,11,1,18,0,,
4740,3,223,85,308,73,29,15,29,36,16,13,1,30,0,,
4740,6,209,98,307,63,31,17,36,29,9,12,0,21,0,,
4741,2,206,121,327,79,19,12,20,23,17,10,3,30,0,,
4741,7,215,137,352,87,24,18,22,20,15,7,1,23,0,,
4742,15,202,89,291,61,30,14,29,35,12,14,0,26,0,,
4742,1,225,69,294,77,25,8,35,32,16,14,3,33,0,,
4743,10,196,116,312,63,17,15,26,29,24,16,3,43,0,,
4743,8,180,105,285,45,28,19,29,26,16,12,4,32,0,,
4744,6,247,157,404,94,28,19,26,28,19,19,1,39,0,,
4744,4,209,111,320,90,14,13,28,25,8,13,3,24,0,,
4745,12,215,91,306,68,24,13,26,22,13,22,0,35,0,,
4745,2,168,86,254,59,30,6,22,26,8,9,3,20,0,,
4746,5,202,107,309,53,26,31,34,27,14,7,1,22,0,,
4746,15,204,49,253,50,24,15,27,34,13,11,3,27,0,,
4747,14,233,120,353,78,26,18,25,32,17,10,3,30,0,,
4747,1,206,79,285,59,30,12,32,25,10,8,1,19,0,,
4748,13,202,88,290,74,11,15,31,21,10,7,1,18,0,,
4748,8,245,115,360,87,27,12,21,31,21,9,2,32,0,,
4749,7,204,122,326,64,38,18,36,23,14,6,2,22,0,,
4749,10,185,101,286,50,25,20,23,36,13,19,2,34,0,,
4750,9,221,89,310,85,28,9,40,27,10,12,2,24,0,,
4750,3,219,110,329,82,21,24,27,40,16,6,1,23,0,,
4751,10,193,119,312,60,15,13,21,11,12,16,0,28,0,,
4751,14,210,106,316,55,24,8,11,21,22,17,2,41,0,,
4752,6,213,82,295,64,25,14,26,29,9,12,1,22,0,,
4752,12,221,67,288,49,33,28,29,26,22,8,3,33,0,,
4753,5,236,113,349,75,23,20,28,34,16,17,1,34,0,,
4753,7,215,103,318,59,24,9,34,28,11,13,1,25,0,,
4754,8,231,112,343,85,21,14,32,19,12,16,0,28,0,,
4754,3,212,61,273,83,28,8,19,32,9,5,3,17,0,,
4755,15,218,86,304,83,23,18,27,31,16,11,2,29,0,,
4755,2,228,136,364,87,23,15,31,27,21,11,3,35,0,,
4756,1,231,91,322,66,27,7,37,33,11,15,3,29,0,,
4756,9,203,99,302,67,25,21,33,37,5,11,2,18,0,,
4757,4,240,121,361,93,18,29,30,28,18,11,3,32,0,,
4757,13,213,78,291,83,15,24,28,30,11,12,0,23,0,,
4758,5,216,93,309,81,29,21,32,36,18,14,0,32,0,,
4758,9,199,77,276,61,20,10,36,32,11,9,1,21,0,,
4759,12,209,97,306,83,27,19,32,23,11,13,0,24,0,,
4759,10,219,115,334,70,23,18,23,32,15,13,4,32,0,,
4760,3,191,80,271,67,30,12,32,29,12,18,0,30,0,,
4760,14,192,101,293,52,28,12,28,32,24,11,2,37,0,,
4761,8,248,117,365,95,24,17,28,24,27,14,2,43,0,,
4761,6,212,107,319,71,17,21,24,28,15,11,3,29,0,,
4762,1,233,97,330,89,22,12,30,31,19,16,2,37,0,,
4762,7,165,108,273,43,21,32,31,30,9,8,1,18,0,,
4763,2,210,118,328,87,23,16,26,34,23,8,3,34,0,,
4763,13,206,98,304,74,26,22,34,26,20,10,1,31,0,,
4764,4,203,123,326,65,15,31,20,22,16,15,4,35,0,,
4764,15,199,103,302,64,17,23,22,20,12,8,4,24,0,,
4765,2,207,114,321,88,31,6,31,26,11,19,1,31,0,,
4765,9,207,100,307,75,21,16,26,33,14,13,3,30,0,,
4766,12,211,106,317,68,17,20,27,24,20,20,1,41,0,,
4766,15,206,92,298,71,26,12,24,27,20,16,1,37,0,,
4767,5,211,144,355,84,27,19,31,29,10,13,1,24,0,,
4767,3,216,101,317,84,30,10,28,34,10,11,2,23,0,,
4768,13,218,96,314,58,16,28,24,28,14,10,6,30,0,,
4768,1,202,82,284,69,27,6,28,24,17,6,2,25,0,,
4769,7,215,102,317,68,27,18,46,30,13,9,1,23,0,,
4769,4,225,113,338,63,20,18,30,46,14,11,2,27,0,,
4770,10,201,131,332,73,30,25,22,21,24,16,0,40,0,,
4770,6,192,112,304,63,20,18,21,22,14,11,2,27,0,,
4771,14,187,112,299,65,25,12,23,24,10,6,2,18,0,,
4771,8,230,143,373,88,38,24,24,23,19,13,1,33,0,,
4772,15,217,90,307,69,20,9,34,33,16,17,0,33,0,,
4772,10,185,111,296,44,22,33,33,34,14,15,2,31,0,,
4773,3,220,100,320,89,25,16,24,30,19,13,1,33,0,,
4773,13,197,61,258,62,18,13,30,24,13,12,0,25,0,,
4774,6,218,138,356,66,33,34,20,32,19,13,0,32,0,,
4774,1,190,96,286,39,17,9,32,20,17,10,1,28,0,,
4775,14,238,173,411,76,26,17,24,29,22,12,2,36,0,,
4775,2,208,148,356,91,29,9,29,24,16,8,4,28,0,,
4776,8,219,154,373,88,22,18,15,29,18,14,1,33,0,,
4776,7,208,102,310,62,26,10,29,15,11,12,0,23,0,,
4777,9,209,75,284,81,15,9,25,27,14,13,0,27,0,,
4777,12,203,78,281,68,19,23,27,25,13,20,2,35,0,,
4778,4,225,123,348,75,20,35,27,33,16,13,2,31,0,,
4778,5,204,118,322,69,17,29,33,27,7,7,2,16,0,,
4779,2,214,149,363,95,22,15,25,15,23,15,4,42,0,,
4779,6,173,128,301,85,16,13,15,25,7,12,0,19,0,,
4780,13,226,65,291,69,24,15,26,29,14,10,2,26,0,,
4780,12,214,55,269,63,31,19,29,26,10,5,1,16,0,,
4781,5,235,126,361,95,27,30,22,27,19,14,1,34,0,,
4781,14,220,103,323,63,22,16,27,22,14,8,2,24,0,,
4782,3,240,69,309,83,28,15,31,33,12,8,4,24,0,,
4782,7,225,94,319,71,31,13,33,31,8,13,4,25,0,,
4783,8,254,128,382,96,18,19,31,26,28,16,0,44,0,,
4783,15,190,88,278,64,25,14,26,31,13,10,1,24,0,,
4784,9,233,113,346,93,33,22,32,32,11,7,4,22,0,,
4784,10,205,116,321,52,20,11,32,32,10,17,4,31,0,,
4785,1,201,115,316,57,21,5,40,29,3,10,1,14,0,,
4785,4,224,75,299,91,16,22,29,40,7,11,0,18,0,,
4786,13,216,58,274,79,35,17,22,23,11,6,1,18,0,,
4786,4,215,74,289,79,24,18,23,22,10,11,0,21,0,,
4787,12,200,100,300,50,34,32,38,24,22,12,1,35,0,,
4787,5,190,111,301,71,26,13,24,38,16,9,2,27,0,,
4788,8,191,68,259,56,30,21,27,31,9,12,0,21,0,,
4788,12,183,38,221,43,27,31,31,27,6,6,3,15,0,,
4789,13,181,68,249,65,24,20,29,18,13,13,4,30,0,,
4789,5,172,84,256,61,27,18,18,29,12,10,0,22,0,,
4790,13,201,64,265,50,25,20,23,29,19,6,0,25,0,,
4790,12,185,65,250,44,40,25,29,23,14,12,2,28,0,,
4791,8,192,100,292,82,18,16,26,22,22,17,3,42,0,,
4791,13,171,54,225,53,16,17,22,26,6,17,3,26,0,,
4792,15,204,99,303,84,22,15,15,14,15,11,3,29,0,,
4792,9,224,133,357,70,31,30,14,15,19,19,4,42,0,,
4793,12,195,74,269,54,28,30,36,27,15,10,4,29,0,,
4793,8,206,103,309,74,20,12,27,38,22,12,5,39,0,,
4794,5,185,110,295,69,20,26,27,31,11,7,1,19,0,,
4794,10,209,146,355,81,36,27,29,29,25,15,0,40,0,,
4795,1,162,80,242,40,10,20,19,25,9,6,2,17,0,,
4795,3,206,128,334,82,33,34,22,19,19,7,0,26,0,,
4796,13,220,76,296,80,60,43,15,21,19,14,0,33,0,,
4796,6,185,112,297,59,29,32,21,15,12,16,1,29,0,,
4797,7,206,130,336,85,25,14,18,31,15,9,2,26,0,,
4797,14,208,97,305,76,20,24,31,18,14,17,1,32,0,,
4798,4,216,80,296,82,19,33,20,24,20,13,0,33,0,,
4798,2,182,129,311,67,25,25,24,20,16,17,6,39,0,,
4799,15,198,86,284,40,26,20,30,20,13,14,0,27,0,,
4799,13,199,61,260,55,27,44,20,30,7,14,3,24,0,,
4800,14,195,118,313,66,17,33,19,27,19,16,1,36,0,,
4800,9,193,78,271,70,16,15,27,19,23,9,3,35,0,,
4801,5,196,94,290,78,33,19,23,18,17,5,0,22,0,,
4801,12,205,120,325,73,20,23,18,23,16,18,0,34,0,,
4802,3,214,106,320,87,32,19,32,43,17,16,1,34,0,,
4802,4,206,78,284,66,37,14,43,32,17,8,4,29,0,,
4803,6,198,122,320,73,26,9,24,17,23,15,6,44,0,,
4803,7,188,95,283,76,16,24,17,24,17,12,1,30,0,,
4804,2,203,99,302,82,22,11,24,18,13,14,1,28,0,,
4804,8,237,119,356,68,23,19,18,24,23,14,3,40,0,,
4805,10,209,186,395,61,24,26,24,22,27,23,2,52,0,,
4805,1,179,51,230,58,13,13,22,24,11,11,2,24,0,,
4806,6,203,109,312,69,27,13,17,30,20,8,1,29,0,,
4806,15,179,88,267,47,21,22,30,17,7,11,2,20,0,,
4807,7,200,142,342,89,24,27,22,27,21,6,1,28,0,,
4807,9,193,109,302,57,37,21,26,22,11,16,1,28,0,,
4808,1,188,80,268,54,24,8,25,31,5,8,2,15,0,,
4808,12,211,99,310,70,22,24,31,25,18,16,3,37,0,,
4809,8,214,123,337,53,27,16,18,25,20,22,3,45,0,,
4809,5,160,101,261,51,18,30,25,18,10,8,0,18,0,,
4810,2,193,119,312,63,34,12,35,32,19,15,1,35,0,,
4810,3,209,77,286,75,48,23,32,35,12,9,3,24,0,,
4811,14,207,89,296,84,20,22,24,33,18,18,2,38,0,,
4811,13,195,64,259,61,34,15,33,24,13,11,5,29,0,,
4812,4,217,120,337,74,28,34,32,30,14,13,0,27,0,,
4812,10,189,151,340,52,41,22,30,32,18,14,2,34,0,,
4813,12,207,112,319,51,27,24,33,33,29,17,0,46,0,,
4813,4,197,106,303,57,28,14,33,33,15,14,0,29,0,,
4814,14,218,61,279,102,30,28,28,32,18,19,0,37,0,,
4814,15,204,85,289,68,19,16,32,28,19,17,5,41,0,,
4815,13,202,79,281,61,27,37,39,33,21,8,5,34,0,,
4815,7,196,127,323,87,20,20,33,39,14,6,2,22,0,,
4816,9,207,128,335,79,35,26,26,17,16,13,5,34,0,,
4816,6,171,115,286,59,35,14,17,26,20,8,1,29,0,,
4817,5,197,108,305,55,30,31,22,20,16,12,2,30,0,,
4817,2,160,116,276,62,32,8,21,23,15,10,0,25,0,,
4818,3,228,106,334,67,48,28,42,39,17,11,0,28,0,,
4818,10,173,104,277,48,45,15,39,42,9,10,2,21,0,,
4819,1,219,92,311,75,43,13,38,29,14,12,0,26,0,,
4819,8,186,96,282,45,27,22,29,38,7,9,4,20,0,,
4820,15,211,101,312,59,19,14,22,30,18,19,0,37,0,,
4820,7,203,105,308,65,22,21,30,22,16,14,0,30,0,,
4821,12,199,92,291,74,15,10,33,34,17,14,0,31,0,,
4821,3,193,82,275,58,62,19,34,33,9,6,2,17,0,,
4822,5,223,110,333,85,34,25,29,34,14,5,0,19,0,,
4822,1,195,82,277,57,20,7,34,29,12,13,0,25,0,,
4823,14,217,101,318,85,24,38,27,29,29,10,0,39,0,,
4823,6,188,114,302,75,27,12,29,27,17,5,2,24,0,,
4824,8,210,116,326,59,28,12,32,35,13,8,6,27,0,,
4824,4,223,100,323,76,11,16,35,32,15,10,4,29,0,,
4825,2,179,103,282,59,21,12,29,45,19,9,3,31,0,,
4825,10,178,107,285,44,17,22,45,29,21,18,2,41,0,,
4826,9,203,134,337,67,36,25,31,20,12,12,2,26,0,,
4826,13,207,90,297,68,21,14,17,25,12,7,2,21,0,,
4827,10,185,127,312,53,40,26,25,36,13,14,2,29,0,,
4827,12,188,79,267,56,22,26,36,25,12,14,1,27,0,,
4828,5,233,121,354,79,25,28,37,40,16,5,4,25,0,,
4828,9,171,110,281,49,28,19,40,37,8,10,0,18,0,,
4829,3,178,110,288,54,41,18,25,25,14,11,1,26,0,,
4829,14,191,89,280,61,32,24,26,26,13,17,1,31,0,,
4830,1,219,58,277,51,6,11,33,41,11,10,2,23,0,,
4830,7,198,73,271,56,21,15,41,33,4,9,1,14,0,,
4831,13,232,69,301,97,24,20,20,20,16,11,3,30,0,,
4831,2,197,80,277,68,16,14,20,20,9,14,1,24,0,,
4832,6,175,127,302,67,28,19,27,16,15,11,3,29,0,,
4832,8,212,116,328,91,28,18,16,27,16,17,0,33,0,,
4833,4,262,89,351,103,20,36,34,32,24,18,0,42,0,,
4833,15,202,87,289,59,24,24,30,33,13,9,1,23,0,,
4834,4,215,58,273,51,15,29,36,41,10,18,3,31,0,,
4834,9,187,71,258,38,19,38,41,36,8,14,0,22,0,,
4835,12,202,110,312,61,31,26,35,28,22,17,1,40,0,,
4835,14,182,88,270,71,17,11,28,35,14,9,1,24,0,,
4836,13,206,102,308,80,23,25,34,24,18,17,1,36,0,,
4836,5,195,109,304,77,25,23,24,34,12,8,0,20,0,,
4837,6,203,111,314,54,30,9,23,28,25,8,1,34,0,,
4837,3,191,108,299,60,38,32,28,23,21,6,2,29,0,,
4838,1,200,85,285,65,12,19,35,22,13,10,0,23,0,,
4838,15,212,112,324,63,23,9,22,35,19,7,1,27,0,,
4839,7,224,93,317,85,19,21,39,29,21,11,0,32,0,,
4839,2,212,99,311,77,28,8,29,39,17,10,2,29,0,,
4840,10,173,124,297,57,30,27,28,21,18,13,1,32,0,,
4840,8,210,148,358,63,40,18,21,28,17,10,2,29,0,,
4841,10,185,106,291,58,14,30,42,27,13,9,0,22,0,,
4841,6,217,137,354,69,30,8,27,42,16,13,7,36,0,,
4842,5,206,89,295,82,28,22,26,32,10,6,2,18,0,,
4842,3,207,98,305,74,43,24,32,26,14,9,1,24,0,,
4843,13,208,62,270,54,15,18,41,37,11,14,1,26,0,,
4843,1,207,67,274,57,16,19,37,41,15,13,2,30,0,,
4844,8,213,99,312,58,38,15,32,38,17,9,1,27,0,,
4844,14,189,74,263,60,27,20,38,32,10,4,1,15,0,,
4845,7,206,85,291,72,31,16,24,40,14,12,1,27,0,,
4845,4,185,75,260,53,36,25,40,24,6,12,1,19,0,,
4846,9,228,141,369,91,29,22,32,19,22,11,1,34,0,,
4846,2,189,141,330,61,19,23,19,32,15,17,2,34,0,,
4847,15,188,72,260,60,25,8,35,39,10,8,3,21,0,,
4847,12,190,122,312,56,20,20,39,35,15,11,4,30,0,,
4848,2,174,99,273,60,27,19,23,26,13,9,7,29,0,,
4848,15,205,130,335,60,23,12,26,23,17,23,3,43,0,,
4849,1,209,79,288,55,29,19,41,26,14,19,0,33,0,,
4849,9,174,132,306,46,26,35,26,41,10,10,1,21,0,,
4850,12,186,64,250,46,28,24,42,40,12,19,1,32,0,,
4850,6,175,85,260,49,27,12,40,42,9,13,3,25,0,,
4851,5,198,121,319,64,32,29,30,34,15,13,2,30,0,,
4851,7,183,100,283,59,21,13,34,30,15,5,4,24,0,,
4852,8,229,152,381,86,38,16,34,34,25,15,0,40,0,,
4852,3,158,96,254,37,29,31,34,34,7,8,1,16,0,,
4853,14,201,110,311,72,30,15,35,39,15,12,2,29,0,,
4853,10,176,123,299,54,30,19,39,35,11,12,1,24,0,,
4854,4,211,114,325,78,25,49,36,36,20,13,2,35,0,,
4854,13,214,69,283,60,16,24,36,36,18,9,2,29,0,,
4855,12,210,127,337,73,27,30,38,21,27,16,6,49,0,,
4855,9,166,88,254,50,19,20,21,38,12,8,1,21,0,,
4856,3,187,90,277,61,36,28,41,28,11,13,1,25,0,,
4856,13,198,69,267,50,20,18,28,41,15,10,2,27,0,,
4857,1,227,96,323,85,23,11,26,30,10,17,2,29,0,,
4857,6,202,127,329,59,31,19,30,26,7,3,1,11,0,,
4858,2,195,79,274,67,24,15,32,26,14,10,3,27,0,,
4858,14,181,101,282,53,23,11,26,31,18,9,1,28,0,,
4859,8,222,139,361,88,32,34,21,28,23,14,2,39,0,,
4859,7,174,94,268,60,22,16,28,21,15,7,1,23,0,,
4860,10,183,125,308,42,25,9,27,27,20,14,2,36,0,,
4860,15,190,107,297,76,27,25,27,27,23,5,2,30,0,,
4861,4,238,114,352,104,21,32,28,31,19,22,1,42,0,,
4861,5,198,118,316,84,16,18,31,28,11,12,2,25,0,,
4862,7,183,91,274,76,29,5,32,33,16,9,1,26,0,,
4862,3,194,97,291,53,27,26,33,32,18,9,4,31,0,,
4863,1,229,90,319,79,11,10,33,37,18,12,1,31,0,,
4863,4,213,87,300,60,17,22,37,33,15,7,2,24,0,,
4864,15,209,91,300,60,20,16,23,23,14,7,0,21,0,,
4864,8,205,135,340,78,32,14,23,23,17,11,0,28,0,,
4865,9,206,158,364,79,41,33,35,26,9,10,0,19,0,,
4865,10,194,120,314,59,17,9,26,35,19,18,5,42,0,,
4866,13,189,71,260,42,25,28,37,17,13,10,2,25,0,,
4866,12,188,114,302,70,24,14,17,37,21,7,2,30,0,,
4867,14,190,111,301,73,21,17,21,32,17,10,3,30,0,,
4867,5,217,102,319,80,52,23,32,21,17,7,1,25,0,,
4868,6,196,96,292,57,24,12,27,33,18,14,1,33,0,,
4868,2,187,88,275,70,23,15,33,27,22,13,4,39,0,,
4869,15,194,84,278,49,29,13,21,26,15,9,1,25,0,,
4869,3,196,95,291,45,25,24,26,21,9,7,3,19,0,,
4870,12,202,91,293,69,27,29,29,33,12,22,3,37,0,,
4870,7,196,81,277,62,23,25,33,29,14,12,0,26,0,,
4871,5,202,85,287,82,20,20,25,19,15,12,4,31,0,,
4871,6,166,113,279,60,30,11,19,25,11,12,2,25,0,,
4872,2,185,99,284,75,20,9,31,29,11,6,2,19,0,,
4872,1,230,98,328,91,17,14,30,29,21,14,2,37,0,,
4873,14,187,128,315,65,32,23,19,29,13,13,0,26,0,,
4873,4,203,85,288,95,18,18,29,19,12,13,0,25,0,,
4874,13,181,96,277,54,31,24,27,31,11,9,1,21,0,,
4874,10,192,148,340,38,40,16,31,27,17,9,1,27,0,,
4875,9,163,91,254,51,16,24,27,22,11,4,0,15,0,,
4875,8,238,128,366,86,41,22,22,27,24,20,1,45,0,,
4876,4,229,83,312,78,24,31,37,25,16,15,3,34,0,,
4876,6,177,115,292,66,18,31,25,37,5,11,1,17,0,,
4877,3,186,69,255,42,25,33,26,46,9,8,2,19,0,,
4877,9,173,37,210,36,31,14,46,26,3,8,1,12,0,,
4878,2,207,58,265,41,22,4,46,35,4,3,0,7,0,,
4878,12,195,38,233,30,30,23,35,46,6,4,3,13,0,,
4879,5,201,82,283,54,13,11,37,27,2,6,0,8,0,,
4879,15,218,70,288,51,22,10,27,37,10,9,3,22,0,,
4880,1,214,67,281,48,17,6,41,42,13,9,2,24,0,,
4880,14,186,52,238,42,24,7,42,41,8,2,0,10,0,,
4881,8,199,77,276,34,21,17,31,33,6,6,2,14,0,,
4881,13,206,45,251,49,24,26,33,31,8,6,3,17,0,,
4882,10,202,179,381,63,25,19,23,23,20,13,1,34,0,,
4882,7,203,118,321,82,27,25,23,23,11,7,2,20,0,,
4883,10,152,84,236,51,26,12,28,23,14,13,4,31,0,,
4883,5,180,103,283,61,19,33,23,28,10,14,0,24,0,,
4884,8,186,106,292,73,40,17,26,31,12,8,0,20,0,,
4884,12,196,73,269,60,18,20,31,26,12,6,1,19,0,,
4885,3,168,58,226,35,31,31,41,30,7,8,2,17,0,,
4885,1,160,50,210,46,22,6,30,41,9,9,1,19,0,,
4886,6,209,123,332,82,25,9,29,36,11,13,3,27,0,,
4886,13,201,56,257,66,22,25,36,29,4,8,2,14,0,,
4887,14,260,135,395,108,23,18,28,25,13,17,3,33,0,,
4887,7,203,126,329,87,28,21,25,28,3,8,1,12,0,,
4888,2,214,132,346,98,25,9,23,28,9,18,1,28,0,,
4888,4,195,91,286,66,37,17,28,23,9,15,0,24,0,,
4889,9,198,122,320,58,16,22,25,13,17,10,1,28,0,,
4889,15,215,95,310,61,12,20,13,25,23,12,1,36,0,,
4890,4,197,102,299,84,25,23,29,32,18,10,0,28,0,,
4890,3,219,79,298,79,22,35,32,29,21,17,3,41,0,,
4891,7,204,161,365,77,26,26,33,26,20,13,1,34,0,,
4891,6,170,136,306,45,32,9,26,33,15,9,1,25,0,,
4892,1,185,74,259,59,18,24,40,34,10,10,3,23,0,,
4892,10,183,102,285,71,39,22,34,40,16,7,3,26,0,,
4893,8,223,141,364,93,30,25,25,30,19,19,1,39,0,,
4893,2,173,97,270,61,20,5,30,25,11,9,2,22,0,,
4894,13,191,114,305,58,19,20,21,17,15,19,1,35,0,,
4894,15,191,102,293,65,22,14,17,21,16,14,2,32,0,,
4895,9,207,107,314,75,27,21,39,31,18,9,2,29,0,,
4895,14,190,80,270,68,16,17,31,39,10,15,3,28,0,,
4896,12,197,97,294,79,19,14,19,25,20,12,4,36,0,,
4896,5,204,99,303,73,37,21,25,19,15,18,4,37,0,,
4897,3,191,93,284,60,18,19,34,32,21,10,1,32,0,,
4897,2,173,89,262,60,25,4,32,34,12,6,5,23,0,,
4898,15,211,100,311,72,28,11,32,18,23,17,1,41,0,,
4898,6,172,121,293,63,26,15,18,32,19,7,2,28,0,,
4899,9,190,126,316,58,38,15,24,24,14,6,3,23,0,,
4899,7,205,98,303,75,23,23,24,24,18,13,0,31,0,,
4900,12,203,133,336,71,31,20,39,36,20,11,2,33,0,,
4900,1,185,82,267,64,15,7,36,39,12,6,0,18,0,,
4901,5,188,110,298,70,14,17,37,37,5,13,0,18,0,,
4901,8,225,172,397,80,33,16,37,37,25,16,2,43,0,,
4902,10,211,143,354,66,0,18,30,31,30,17,4,51,0,,
4902,4,185,76,261,76,0,10,31,30,10,10,1,21,0,,
4903,13,224,101,325,85,16,20,24,37,18,9,0,27,0,,
4903,14,210,129,339,87,20,11,37,24,11,11,0,22,0,,
4904,4,204,84,288,63,24,28,34,32,15,14,3,32,0,,
4904,12,178,95,273,56,21,26,32,34,15,11,3,29,0,,
4905,8,231,137,368,92,30,22,28,35,25,10,2,37,0,,
4905,1,183,78,261,54,11,23,35,28,9,11,0,20,0,,
4906,15,186,97,283,59,32,5,34,35,11,12,1,24,0,,
4906,14,230,123,353,89,20,18,35,34,27,13,1,41,0,,
4907,7,229,147,376,95,15,12,37,31,18,5,1,24,0,,
4907,13,202,80,282,72,29,25,31,37,9,13,1,23,0,,
4908,6,226,121,347,83,39,9,29,25,17,27,2,46,0,,
4908,9,193,130,323,63,27,21,25,29,16,8,2,26,0,,
4909,2,193,179,372,71,27,8,24,25,18,15,5,38,0,,
4909,5,170,111,281,70,21,14,25,24,14,4,1,19,0,,
4910,10,219,137,356,68,36,19,28,21,36,18,2,56,0,,
4910,3,143,107,250,57,25,27,21,28,11,7,0,18,0,,
4911,10,202,157,359,61,17,17,23,27,31,11,1,43,0,,
4911,2,184,156,340,68,23,16,27,23,15,17,0,32,0,,
4912,13,215,86,301,64,21,29,28,24,22,20,1,43,0,,
4912,9,197,83,280,70,29,19,24,28,14,14,1,29,0,,
4913,3,180,96,276,56,24,22,35,42,10,8,1,19,0,,
4913,12,185,79,264,63,20,14,42,35,10,10,0,20,0,,
4914,1,212,128,340,69,10,11,32,36,9,10,1,20,0,,
4914,5,198,98,296,68,29,16,36,32,8,4,2,14,0,,
4915,6,208,141,349,77,35,9,20,24,20,9,0,29,0,,
4915,14,189,124,313,45,24,23,24,20,12,12,3,27,0,,
4916,7,204,127,331,62,28,8,44,34,15,15,1,31,0,,
4916,15,185,88,273,49,19,10,34,44,11,13,2,26,0,,
4917,4,211,106,317,76,22,33,19,19,17,12,1,30,0,,
4917,8,220,140,360,83,23,20,19,19,17,9,3,29,0,,
4918,15,223,86,309,56,20,30,28,31,18,10,2,30,0,,
4918,4,201,119,320,60,21,42,31,28,15,15,4,34,0,,
4919,12,219,142,361,87,18,20,32,30,17,21,0,38,0,,
4919,10,161,88,249,49,41,10,30,32,8,6,1,15,0,,
4920,14,228,115,343,80,34,12,29,34,12,18,2,32,0,,
4920,3,205,105,310,83,32,12,34,29,9,9,2,20,0,,
4921,8,235,118,353,112,28,24,33,29,26,8,1,35,0,,
4921,6,192,134,326,71,20,11,29,33,16,8,1,25,0,,
4922,7,214,120,334,84,24,19,27,29,15,13,1,29,0,,
4922,1,206,113,319,72,13,20,29,27,15,11,0,26,0,,
4923,2,188,83,271,61,22,5,26,17,15,9,1,25,0,,
4923,13,211,83,294,58,21,15,17,26,17,14,3,34,0,,
4924,9,176,76,252,51,18,16,31,28,11,11,0,22,0,,
4924,5,217,93,310,96,17,13,28,31,14,15,1,30,0,,
4925,14,183,118,301,61,29,11,26,38,13,7,3,23,0,,
4925,12,231,126,357,89,35,25,38,26,24,10,2,36,0,,
4926,5,192,111,303,84,24,18,26,23,8,10,1,19,0,,
4926,13,212,101,313,75,16,23,23,26,15,22,2,39,0,,
4927,3,210,112,322,81,36,25,16,32,20,6,1,27,0,,
4927,6,186,76,262,58,26,6,32,16,11,16,4,31,0,,
4928,15,212,84,296,48,30,18,27,24,18,15,2,35,0,,
4928,1,202,74,276,79,23,18,24,27,18,16,1,35,0,,
4929,8,214,119,333,89,21,11,31,36,20,17,5,42,0,,
4929,10,156,80,236,49,32,12,35,31,15,6,1,22,0,,
4930,2,191,119,310,62,15,18,31,26,19,19,0,38,0,,
4930,7,171,120,291,58,16,10,26,31,8,9,0,17,0,,
4931,9,199,97,296,65,20,12,34,18,18,10,1,29,0,,
4931,4,214,92,306,83,18,22,18,34,21,11,3,35,0,,
4932,13,240,107,347,84,17,21,24,25,18,19,2,39,0,,
4932,4,204,87,291,82,21,10,25,24,10,6,2,18,0,,
4933,6,190,80,270,64,25,5,24,25,12,11,1,24,0,,
4933,12,201,151,352,69,21,27,25,24,17,18,4,39,0,,
4934,7,206,124,330,83,20,22,28,34,15,14,3,32,0,,
4934,5,179,103,282,53,18,22,34,28,8,10,0,18,0,,
4935,3,188,121,309,69,25,20,28,37,9,8,2,19,0,,
4935,8,203,136,339,56,45,11,37,28,17,10,2,29,0,,
4936,15,183,111,294,41,17,10,24,21,18,14,0,32,0,,
4936,2,198,108,306,51,19,12,21,24,11,14,4,29,0,,
4937,9,189,74,263,65,21,17,34,23,10,10,1,21,0,,
4937,1,210,119,329,75,9,7,23,34,22,20,1,43,0,,
4938,10,177,135,312,61,29,13,34,21,18,11,3,32,0,,
4938,14,220,109,329,84,19,18,21,34,18,20,3,41,0,,
4939,2,177,85,262,45,20,10,29,33,17,10,1,28,0,,
4939,9,241,76,317,85,15,16,33,29,26,11,2,39,0,,
4940,12,205,96,301,81,28,33,24,30,20,9,0,29,0,,
4940,15,206,86,292,54,20,13,30,24,19,9,2,30,0,,
4941,6,197,101,298,82,19,4,29,22,20,12,1,33,0,,
4941,10,185,119,304,54,21,33,22,29,20,20,1,41,0,,
4942,1,192,101,293,59,18,10,32,32,10,8,0,18,0,,
4942,13,203,81,284,65,17,23,32,32,12,9,2,23,0,,
4943,14,217,119,336,84,21,23,22,24,17,18,3,38,0,,
4943,8,211,131,342,89,29,17,24,22,19,10,2,31,0,,
4944,3,210,109,319,75,30,35,26,24,21,12,1,34,0,,
4944,5,196,136,332,77,24,13,24,27,23,5,1,29,0,,
4945,4,241,137,378,106,21,38,29,26,26,17,2,45,0,,
4945,7,204,129,333,91,20,17,26,29,13,9,0,22,0,,
4946,8,237,116,353,95,27,10,23,22,23,16,2,41,0,,
4946,10,142,92,234,34,22,16,22,23,8,8,1,17,0,,
4947,13,209,78,287,81,19,19,24,20,22,24,2,48,0,,
4947,15,145,66,211,58,15,11,20,24,5,10,0,15,0,,
4948,12,181,57,238,64,28,29,40,33,11,12,2,25,0,,
4948,8,175,100,275,50,31,7,33,40,10,4,1,15,0,,
4949,13,195,77,272,68,23,27,22,33,21,18,5,44,0,,
4949,10,178,81,259,46,14,19,33,22,10,12,1,23,0,,
4950,8,213,118,331,76,26,13,28,27,11,12,2,25,0,,
4950,13,191,81,272,55,22,24,27,28,10,14,4,28,0,,
4951,12,181,61,242,63,16,23,20,24,15,14,0,29,0,,
4951,8,180,105,285,52,23,13,24,20,9,12,5,26,0,,
4952,11,211,162,373,101,51,64,27,16,26,9,1,36,59,59.3%,44.1%
4952,3,141,190,331,73,73,18,16,27,10,8,2,20,32,56.2%,31.2%
4953,14,207,205,412,125,48,24,20,20,14,9,3,26,50,46.0%,28.0%
4953,1,184,214,398,81,50,29,20,20,12,8,2,22,48,41.7%,25.0%
4954,9,201,116,317,92,72,34,17,13,16,13,2,31,54,53.7%,29.6%
4954,12,191,160,351,81,55,50,13,16,15,12,2,29,52,51.9%,28.8%
4955,7,256,183,439,147,60,36,21,15,12,6,2,20,49,36.7%,24.5%
4955,5,161,113,274,74,55,19,15,21,7,8,2,17,34,44.1%,20.6%
4956,1,248,221,469,109,57,39,18,11,16,11,0,27,60,45.0%,26.7%
4956,9,170,148,318,87,79,25,11,18,8,8,0,16,50,32.0%,16.0%
4957,5,204,138,342,97,69,28,12,15,12,9,2,23,47,44.7%,25.5%
4957,11,193,253,446,95,38,45,15,12,11,11,1,23,55,40.0%,20.0%
4958,7,205,173,378,102,64,44,17,17,9,6,0,15,40,37.5%,22.5%
4958,1,219,181,400,96,72,36,17,17,7,9,2,18,57,28.1%,12.3%
4959,14,251,196,447,135,50,49,12,18,17,17,1,35,51,66.7%,33.3%
4959,5,174,112,286,65,59,21,18,12,6,10,1,17,44,36.4%,13.6%
4960,7,183,138,321,58,118,53,23,19,9,10,4,23,58,32.8%,15.5%
4960,14,186,168,354,52,96,48,19,23,12,8,0,20,42,47.6%,28.6%
4961,7,206,142,348,112,75,50,25,30,14,3,0,17,43,39.5%,32.6%
4961,8,185,180,365,71,51,35,31,24,13,7,2,22,52,38.5%,25.0%
4962,5,223,196,419,110,51,30,24,21,19,13,0,32,58,55.2%,32.8%
4962,2,170,177,347,97,55,24,21,24,6,9,0,15,37,40.5%,16.2%
4963,14,226,237,463,122,67,24,27,21,19,12,1,32,56,55.4%,33.9%
4963,9,186,155,341,88,74,24,21,27,9,6,4,19,44,34.1%,20.5%
4964,4,190,153,343,78,37,42,27,14,11,13,4,28,43,55.8%,25.6%
4964,12,235,158,393,132,53,30,15,27,15,16,3,34,57,54.4%,26.3%
4965,15,188,135,323,82,70,56,19,17,18,11,0,29,48,60.4%,37.5%
4965,3,197,200,397,104,57,32,17,19,18,12,2,32,55,54.5%,32.7%
4966,1,236,218,454,112,68,34,21,8,24,12,2,38,63,57.1%,38.1%
4966,16,151,145,296,79,66,32,8,21,12,3,1,16,41,36.6%,29.3%
4967,13,219,135,354,99,67,39,24,19,22,8,2,32,57,52.6%,38.6%
4967,10,169,170,339,78,52,33,19,24,10,8,1,19,45,40.0%,22.2%
4968,18,208,141,349,96,72,44,25,20,13,5,5,23,39,46.2%,33.3%
4968,11,171,164,335,76,70,37,20,25,9,12,3,24,46,45.7%,19.6%
4969,14,232,165,397,123,61,33,19,23,18,10,3,31,64,43.8%,28.1%
4969,12,183,146,329,79,48,37,23,19,12,4,3,19,49,32.7%,24.5%
4970,8,241,223,464,129,72,51,19,19,24,10,1,35,58,58.6%,41.4%
4970,16,159,177,336,76,72,25,19,19,5,8,1,14,43,30.2%,11.6%
4971,7,205,172,377,106,51,32,21,24,17,12,1,30,53,54.7%,32.1%
4971,2,195,145,340,101,43,37,26,21,14,8,2,24,48,45.8%,29.2%
4972,5,212,179,391,105,76,34,15,16,6,12,6,24,40,45.0%,15.0%
4972,11,192,145,337,105,58,32,16,15,7,5,4,16,46,26.1%,15.2%
4973,10,201,159,360,95,62,40,22,22,17,10,2,29,47,57.4%,36.2%
4973,1,168,88,256,72,61,35,22,22,10,8,2,20,43,41.9%,23.3%
4974,18,184,127,311,69,70,32,27,18,17,8,2,27,57,43.9%,29.8%
4974,13,195,186,381,84,65,49,18,27,11,11,6,28,44,50.0%,25.0%
4975,3,171,150,321,74,73,33,19,19,10,7,1,18,43,39.5%,23.3%
4975,9,218,194,412,118,70,25,19,19,14,10,1,25,53,45.3%,26.4%
4976,4,214,164,378,102,68,48,27,13,14,8,2,24,47,46.8%,29.8%
4976,15,187,196,383,78,66,24,13,27,16,10,4,30,60,43.3%,26.7%
4977,13,211,209,420,54,88,41,19,13,9,8,4,21,52,32.7%,17.3%
4977,1,236,131,367,70,83,37,14,19,10,9,1,20,61,31.1%,16.4%
4978,4,186,137,323,85,65,60,29,20,15,10,2,27,52,48.1%,28.8%
4978,8,190,134,324,97,71,30,20,28,14,9,1,24,45,51.1%,31.1%
4979,3,188,224,412,82,105,35,15,17,16,8,2,26,55,43.6%,29.1%
4979,18,179,172,351,74,91,58,17,15,17,6,1,24,58,39.7%,29.3%
4980,9,188,185,373,76,54,21,15,20,15,6,4,25,56,37.5%,26.8%
4980,16,198,198,396,82,70,40,20,14,15,21,2,38,65,55.4%,23.1%
4981,5,226,221,447,96,67,38,12,13,23,13,6,42,70,51.4%,32.9%
4981,15,196,192,388,80,65,40,13,12,14,7,0,21,37,56.8%,37.8%
4982,14,229,173,402,105,86,48,27,22,19,10,2,31,64,45.3%,29.7%
4982,10,171,154,325,69,65,43,22,27,9,4,1,14,36,36.1%,25.0%
4983,11,211,146,357,112,67,58,17,15,15,11,3,29,53,49.1%,28.3%
4983,2,191,127,318,100,76,25,15,17,7,9,3,19,31,51.6%,22.6%
4984,7,177,141,318,77,68,45,16,13,9,13,1,23,42,52.4%,21.4%
4984,12,247,152,399,136,77,39,13,16,20,8,1,29,47,59.6%,42.6%
4985,7,236,188,424,130,61,38,16,23,10,8,1,19,43,41.9%,23.3%
4985,5,193,144,337,73,68,28,23,16,4,15,2,21,51,37.3%,7.8%
4986,15,237,199,436,120,48,32,27,17,17,13,1,31,54,55.6%,31.5%
4986,4,196,212,408,99,54,40,17,27,13,8,5,26,52,40.4%,25.0%
4987,10,242,192,434,141,48,30,17,16,16,15,0,31,54,57.4%,29.6%
4987,2,164,127,291,75,50,30,16,16,7,12,2,21,54,35.2%,13.0%
4988,12,183,130,313,72,80,37,18,19,10,13,2,25,42,54.8%,23.8%
4988,3,217,187,404,98,69,32,19,18,13,12,5,30,54,46.3%,24.1%
4989,18,202,190,392,88,44,17,21,23,11,14,1,26,52,48.1%,21.2%
4989,9,230,157,387,108,68,47,23,21,16,11,1,28,58,46.6%,27.6%
4990,13,202,194,396,96,72,34,20,12,7,14,1,22,48,43.8%,14.6%
4990,11,205,197,402,109,43,29,12,20,5,9,2,16,50,28.0%,10.0%
4991,1,222,174,396,112,60,35,19,16,14,14,2,30,51,54.9%,27.5%
4991,8,207,174,381,102,54,33,16,19,12,9,3,24,57,36.8%,21.1%
4992,16,180,151,331,73,66,43,19,18,18,12,5,35,59,50.8%,30.5%
4992,14,198,212,410,97,67,23,18,19,17,14,2,33,50,62.0%,34.0%
4993,1,235,192,427,121,64,27,18,10,18,11,2,31,48,60.4%,37.5%
4993,11,165,227,392,98,65,35,10,18,10,7,5,22,47,36.2%,21.3%
4994,10,207,207,414,95,64,29,19,19,17,10,3,30,53,50.9%,32.1%
4994,4,184,95,279,88,72,43,19,19,9,8,1,18,52,32.7%,17.3%
4995,13,194,199,393,91,66,42,23,27,15,11,2,28,59,44.1%,25.4%
4995,9,188,162,350,87,94,30,27,23,7,9,2,18,50,32.0%,14.0%
4996,18,214,199,413,108,82,41,21,13,7,10,2,19,46,37.0%,15.2%
4996,7,194,203,397,89,82,36,13,21,6,5,3,14,41,26.8%,14.6%
4997,5,226,175,401,93,72,32,23,18,18,10,2,30,67,41.8%,26.9%
4997,3,195,198,393,86,58,29,18,23,8,7,0,15,43,34.9%,18.6%
4998,8,207,159,366,117,63,28,29,28,10,10,0,20,42,47.6%,23.8%
4998,15,180,128,308,74,93,57,28,29,12,7,3,22,47,40.4%,25.5%
4999,16,186,162,348,91,62,46,25,27,15,20,2,37,47,74.5%,31.9%
4999,2,166,183,349,65,68,22,27,25,11,7,0,18,41,43.9%,26.8%
5000,12,199,157,356,103,68,23,18,14,15,11,3,29,52,50.0%,28.8%
5000,14,172,164,336,85,55,34,14,18,9,12,2,23,43,48.8%,20.9%
5001,3,229,205,434,139,62,33,16,13,16,7,5,28,45,51.1%,35.6%
5001,7,193,179,372,93,52,37,13,15,11,9,0,20,52,38.5%,21.2%
5002,5,216,195,411,99,74,38,19,18,15,12,3,30,53,50.9%,28.3%
5002,12,155,166,321,57,66,40,18,19,9,2,1,12,44,25.0%,20.5%
5003,18,191,126,317,78,61,37,29,22,13,14,0,27,50,54.0%,26.0%
5003,8,172,151,323,76,75,39,22,29,12,10,2,24,46,47.8%,26.1%
5004,9,195,163,358,84,71,29,12,25,9,8,2,19,50,34.0%,18.0%
5004,13,230,169,399,110,68,41,25,12,11,7,1,19,54,33.3%,20.4%
5005,10,173,166,339,73,62,42,23,23,9,12,6,27,52,40.4%,17.3%
5005,14,218,186,404,128,76,35,23,23,20,4,1,25,48,50.0%,41.7%
5006,2,184,181,365,65,68,34,16,23,15,8,2,25,46,50.0%,32.6%
5006,11,209,163,372,100,69,38,23,16,11,11,3,25,45,48.9%,24.4%
5007,1,243,207,450,144,51,38,14,15,22,11,0,33,58,56.9%,37.9%
5007,15,181,178,359,92,60,25,15,13,10,11,1,22,48,43.8%,20.8%
5008,16,189,178,367,76,65,34,25,23,24,12,4,40,62,58.1%,38.7%
5008,4,193,164,357,103,50,31,23,25,13,5,2,20,41,43.9%,31.7%
5009,16,188,178,366,82,67,46,22,15,15,6,1,22,46,45.7%,32.6%
5009,5,207,179,386,78,93,31,15,22,20,10,3,33,54,55.6%,37.0%
5010,13,184,230,414,83,51,32,13,22,6,9,1,16,47,31.9%,12.8%
5010,4,234,150,384,130,64,30,22,13,10,14,1,25,59,40.7%,16.9%
5011,1,233,155,388,118,44,36,20,13,14,13,4,31,46,58.7%,30.4%
5011,10,181,131,312,90,57,26,13,20,9,7,2,18,46,34.8%,19.6%
5012,9,165,173,338,73,63,28,13,14,10,12,2,24,50,44.0%,20.0%
5012,14,258,229,487,137,45,35,14,13,24,10,1,35,65,52.3%,36.9%
5013,15,211,210,421,104,65,43,12,14,12,10,2,24,49,44.9%,24.5%
5013,11,253,150,403,161,62,41,14,12,11,9,0,20,45,44.4%,24.4%
5014,2,183,176,359,88,72,33,26,26,13,4,4,21,54,31.5%,24.1%
5014,8,173,144,317,79,73,46,26,24,13,11,0,24,38,63.2%,34.2%
5015,18,175,167,342,53,65,39,22,24,14,7,1,22,49,42.9%,28.6%
5015,12,218,158,376,120,84,38,24,22,17,11,5,33,56,50.0%,30.4%
5016,7,213,185,398,101,67,36,27,20,11,13,2,26,54,44.4%,20.4%
5016,3,181,141,322,90,73,32,20,27,14,8,1,23,43,51.2%,32.6%
5017,15,203,162,365,91,68,41,28,21,14,13,0,27,53,50.9%,26.4%
5017,12,205,143,348,95,72,41,21,28,10,6,2,18,42,38.1%,23.8%
5018,8,193,175,368,89,85,43,23,14,19,10,0,29,50,58.0%,38.0%
5018,11,187,160,347,102,76,51,15,23,11,8,3,22,40,47.5%,27.5%
5019,3,175,143,318,88,67,32,18,14,12,10,1,23,42,52.4%,28.6%
5019,14,229,194,423,118,51,34,14,18,23,12,4,39,62,56.5%,37.1%
5020,18,190,137,327,77,85,32,30,16,8,6,1,15,31,45.2%,25.8%
5020,10,236,149,385,123,68,42,16,29,14,3,6,23,51,33.3%,27.5%
5021,2,196,171,367,83,66,22,23,21,19,12,0,31,57,54.4%,33.3%
5021,4,199,162,361,104,72,40,21,23,11,9,2,22,44,45.5%,25.0%
5022,1,221,205,426,114,63,34,24,11,17,16,3,36,58,56.9%,29.3%
5022,9,208,148,356,122,71,23,11,24,8,6,2,16,45,31.1%,17.8%
5023,16,170,148,318,76,66,56,21,12,10,6,1,17,39,41.0%,25.6%
5023,7,207,141,348,118,68,28,12,21,12,12,1,25,54,44.4%,22.2%
5024,13,204,205,409,114,48,37,12,17,11,9,1,21,38,52.6%,28.9%
5024,5,214,133,347,103,91,22,17,12,9,18,4,31,58,46.6%,15.5%
5025,8,196,129,325,73,77,26,20,18,14,16,2,32,60,50.0%,23.3%
5025,3,195,186,381,86,74,45,18,20,13,6,2,21,47,40.4%,27.7%
5026,9,188,172,360,98,70,33,18,23,12,9,5,26,49,42.9%,24.5%
5026,2,195,171,366,93,45,24,24,18,15,10,5,30,53,47.2%,28.3%
5027,12,210,171,381,103,77,28,20,19,12,12,3,27,55,43.6%,21.8%
5027,16,180,151,331,80,72,60,19,20,14,9,3,26,42,54.8%,33.3%
5028,15,199,194,393,95,60,32,17,22,19,13,2,34,55,58.2%,34.5%
5028,18,202,170,372,105,61,32,22,17,14,8,1,23,45,48.9%,31.1%
5029,4,198,178,376,97,44,32,19,14,9,4,1,14,39,33.3%,23.1%
5029,1,243,182,425,118,55,31,14,19,17,16,1,34,64,51.6%,26.6%
5030,7,245,171,416,122,77,29,20,19,10,10,0,20,55,36.4%,18.2%
5030,14,196,178,374,91,58,46,19,20,6,5,5,16,52,21.2%,11.5%
5031,10,201,163,364,70,56,40,19,12,10,10,1,21,44,45.5%,22.7%
5031,5,217,147,364,89,75,33,12,19,13,13,5,31,63,41.3%,20.6%
5032,11,215,211,426,97,52,33,18,23,16,14,7,37,60,50.0%,26.7%
5032,13,175,178,353,95,74,42,23,18,11,5,2,18,29,55.2%,37.9%
5033,12,200,188,388,92,64,38,24,20,18,9,3,30,58,46.6%,31.0%
5033,9,169,158,327,93,71,35,20,24,9,8,3,20,39,43.6%,23.1%
5034,8,207,135,342,107,76,27,13,19,12,7,0,19,48,39.6%,25.0%
5034,1,213,163,376,97,58,33,20,13,11,8,2,21,52,36.5%,21.2%
5035,16,223,151,374,130,43,25,23,18,17,11,2,30,52,53.8%,32.7%
5035,18,199,175,374,106,47,19,18,23,8,9,1,18,44,38.6%,18.2%
5036,11,199,155,354,96,66,41,25,21,19,7,3,29,58,44.8%,32.8%
5036,3,172,185,357,73,73,45,21,25,5,8,2,15,32,40.6%,15.6%
5037,5,252,168,420,146,61,20,14,23,20,12,3,35,55,58.2%,36.4%
5037,4,172,180,352,86,47,34,23,14,7,7,3,17,41,34.1%,17.1%
5038,14,227,278,505,122,63,29,25,18,14,11,3,28,50,50.0%,28.0%
5038,15,183,189,372,82,41,26,18,25,9,7,2,18,47,34.0%,19.1%
5039,2,197,148,345,88,90,30,18,17,14,4,1,19,44,40.9%,31.8%
5039,10,193,163,356,97,81,46,17,18,12,11,2,25,42,54.8%,28.6%
5040,7,229,193,422,125,73,39,18,14,15,5,5,25,50,40.0%,30.0%
5040,13,184,155,339,89,68,45,14,18,9,8,3,20,33,51.5%,27.3%
5041,3,203,177,380,115,75,37,14,19,15,8,1,24,48,47.9%,31.2%
5041,1,195,152,347,79,66,38,19,14,14,5,1,20,49,38.8%,28.6%
5042,14,215,219,434,104,54,27,23,23,18,10,3,31,57,49.1%,31.6%
5042,13,170,158,328,74,63,36,23,23,10,5,2,17,37,40.5%,27.0%
5043,18,202,97,299,37,116,41,22,24,3,7,5,15,50,20.0%,6.0%
5043,2,228,91,319,37,142,44,24,22,10,9,8,27,47,40.4%,21.3%
5044,9,260,169,429,143,49,30,15,20,13,9,1,23,55,40.0%,23.6%
5044,5,205,179,384,89,63,30,20,15,11,10,4,25,54,38.9%,20.4%
5045,7,219,225,444,106,62,29,27,23,19,8,1,28,55,49.1%,34.5%
5045,11,175,183,358,91,47,45,23,27,12,2,2,16,43,32.6%,27.9%
5046,8,189,112,301,85,77,26,16,19,10,16,3,29,55,47.3%,18.2%
5046,10,183,133,316,77,88,62,19,16,11,10,1,22,40,52.5%,27.5%
5047,12,232,190,422,120,90,24,18,17,15,13,2,30,53,52.8%,28.3%
5047,4,184,139,323,97,68,45,17,18,11,7,3,21,48,37.5%,22.9%
5048,16,220,206,426,103,62,40,21,19,21,11,2,34,58,55.2%,36.2%
5048,15,185,164,349,73,73,32,19,21,11,10,2,23,50,42.0%,22.0%
5049,3,149,175,324,66,44,41,13,13,10,4,0,14,43,32.6%,23.3%
5049,5,231,182,413,118,73,29,13,13,24,15,3,42,60,65.0%,40.0%
5050,16,175,124,299,95,67,26,16,16,13,8,1,22,32,65.6%,40.6%
5050,10,207,170,377,92,61,47,16,16,14,10,2,26,55,43.6%,25.5%
5051,12,193,205,398,76,64,41,29,18,23,16,2,41,62,62.9%,37.1%
5051,2,167,154,321,91,55,27,18,29,10,4,3,17,39,35.9%,25.6%
5052,18,223,175,398,86,88,24,21,16,8,11,2,21,49,38.8%,16.3%
5052,4,183,137,320,63,71,53,16,20,8,10,2,20,38,47.4%,21.1%
5053,1,189,183,372,82,50,35,17,12,9,2,4,15,51,21.6%,17.6%
5053,14,230,218,448,110,56,34,12,17,25,10,1,36,65,53.8%,38.5%
5054,9,188,207,395,88,72,40,9,17,13,18,1,32,56,55.4%,23.2%
5054,11,171,159,330,89,49,39,17,9,15,12,2,29,49,55.1%,30.6%
5055,8,216,154,370,79,78,42,24,20,15,6,3,24,54,38.9%,27.8%
5055,13,205,109,314,76,82,44,20,24,12,6,0,18,44,40.9%,27.3%
5056,15,187,187,374,94,54,41,23,13,9,9,0,18,35,51.4%,25.7%
5056,7,216,203,419,122,64,25,13,23,17,12,1,30,53,54.7%,32.1%
5057,5,202,159,361,84,52,27,21,20,6,13,1,20,48,39.6%,12.5%
5057,14,262,222,484,148,65,29,20,21,12,13,1,26,55,45.5%,21.8%
5058,15,181,161,342,90,52,32,18,20,7,12,3,22,53,35.8%,13.2%
5058,1,272,194,466,157,52,31,20,18,20,6,1,27,47,55.3%,42.6%
5059,10,204,156,360,78,81,30,23,24,9,6,3,18,53,28.3%,17.0%
5059,16,170,114,284,45,97,46,25,22,14,13,3,30,49,55.1%,28.6%
5060,13,191,184,375,73,71,38,26,21,17,6,3,26,51,45.1%,33.3%
5060,18,210,157,367,80,71,30,21,26,16,12,2,30,57,49.1%,28.1%
5061,3,212,178,390,110,67,42,22,16,19,11,5,35,56,53.6%,33.9%
5061,2,159,153,312,63,68,28,16,22,14,8,3,25,46,47.8%,30.4%
5062,11,175,184,359,68,58,31,18,20,13,12,3,28,55,45.5%,23.6%
5062,9,199,171,370,90,85,48,20,18,11,14,1,26,59,42.4%,18.6%
5063,12,192,167,359,97,73,45,23,15,8,9,3,20,48,35.4%,16.7%
5063,8,209,127,336,109,80,38,15,23,16,13,1,30,55,52.7%,29.1%
5064,4,179,191,370,83,68,55,21,20,8,7,1,16,37,40.5%,21.6%
5064,7,206,161,367,95,89,31,21,21,13,8,5,26,51,41.2%,25.5%
5065,4,190,167,357,70,85,48,27,19,15,8,3,26,48,47.9%,31.2%
5065,3,171,185,356,64,90,31,19,27,11,9,3,23,49,40.8%,22.4%
5066,15,169,111,280,86,69,42,19,16,8,6,6,20,44,31.8%,18.2%
5066,10,201,153,354,97,71,43,16,19,14,10,6,30,49,49.0%,28.6%
5067,11,161,198,359,84,57,41,18,13,6,15,4,25,41,51.2%,14.6%
5067,12,214,180,394,142,67,33,13,18,16,5,2,23,36,58.3%,44.4%
5068,9,222,160,382,101,61,28,14,20,13,19,4,36,72,44.4%,18.1%
5068,1,180,161,341,73,52,30,20,13,12,6,1,19,39,46.2%,30.8%
5069,5,221,188,409,94,77,28,15,15,17,18,3,38,70,50.0%,24.3%
5069,8,188,201,389,106,46,46,15,15,8,7,4,19,33,45.5%,24.2%
5070,2,189,130,319,80,63,30,23,20,11,11,1,23,46,47.8%,23.9%
5070,13,214,217,431,109,66,42,20,23,20,12,1,33,58,55.2%,34.5%
5071,14,229,250,479,119,66,44,26,16,23,20,1,44,60,71.7%,38.3%
5071,18,179,172,351,81,56,18,16,26,10,3,1,14,37,35.1%,27.0%
5072,7,237,204,441,107,57,23,20,20,16,10,2,28,56,46.4%,28.6%
5072,16,186,198,384,95,68,39,20,20,14,4,5,23,51,35.3%,27.5%
5073,2,164,149,313,70,57,32,14,19,8,10,1,19,38,47.4%,21.1%
5073,7,234,171,405,141,79,38,19,14,14,11,2,27,56,44.6%,25.0%
5074,12,227,139,366,86,90,38,25,27,15,5,6,26,59,33.9%,25.4%
5074,13,196,155,351,70,73,39,27,25,9,3,3,15,47,25.5%,19.1%
5075,11,225,171,396,111,62,30,16,16,16,9,0,25,65,38.5%,24.6%
5075,16,150,151,301,65,80,44,16,16,12,6,4,22,45,40.0%,26.7%
5076,4,209,147,356,102,61,50,24,17,14,11,3,28,49,51.0%,28.6%
5076,14,202,186,388,84,72,33,17,24,18,13,1,32,55,56.4%,32.7%
5077,15,186,148,334,88,66,35,20,22,12,14,4,30,50,52.0%,24.0%
5077,9,222,174,396,143,50,28,22,20,13,7,4,24,44,45.5%,29.5%
5078,10,196,133,329,55,93,64,23,14,12,16,1,29,62,45.2%,19.4%
5078,3,182,153,335,76,101,38,14,23,12,8,0,20,46,43.5%,26.1%
5079,8,232,117,349,109,69,37,22,24,10,12,2,24,45,48.9%,22.2%
5079,18,192,159,351,70,85,39,24,21,8,10,5,23,46,39.1%,17.4%
5080,5,212,190,402,89,75,25,17,23,17,8,3,28,68,36.8%,25.0%
5080,1,199,166,365,90,67,36,23,17,16,5,2,23,54,38.9%,29.6%
5081,9,205,144,349,101,53,32,14,21,16,10,1,27,56,46.4%,28.6%
5081,12,195,171,366,64,56,34,21,14,12,14,2,28,56,46.4%,21.4%
5082,5,184,151,335,76,94,32,19,21,12,13,1,26,52,48.1%,23.1%
5082,13,198,154,352,92,78,40,21,19,12,10,3,25,54,40.7%,22.2%
5083,4,200,172,372,71,73,44,30,25,12,10,4,26,60,36.7%,20.0%
5083,18,202,152,354,87,87,28,25,30,13,7,4,24,37,54.1%,35.1%
5084,7,251,191,442,142,52,39,19,20,23,5,0,28,54,51.9%,42.6%
5084,15,175,141,316,90,67,49,20,19,6,2,1,9,37,21.6%,16.2%
5085,11,180,162,342,87,52,40,14,19,11,8,1,20,44,43.2%,25.0%
5085,10,212,169,381,105,65,33,19,14,18,8,2,28,52,50.0%,34.6%
5086,3,194,172,366,89,66,25,25,18,9,13,2,24,56,39.3%,16.1%
5086,16,173,173,346,92,61,48,18,25,17,5,6,28,60,36.7%,28.3%
5087,2,178,158,336,79,43,25,21,21,7,5,1,13,39,30.8%,17.9%
5087,1,235,194,429,118,68,30,21,21,17,17,1,35,71,47.9%,23.9%
5088,8,198,141,339,92,62,22,17,27,13,11,2,26,50,48.0%,26.0%
5088,14,198,230,428,93,64,46,27,17,14,14,2,30,47,59.6%,29.8%
5089,2,166,129,295,66,59,26,23,17,9,8,2,19,45,37.8%,20.0%
5089,12,245,187,432,136,78,44,18,23,18,8,4,30,57,45.6%,31.6%
5090,14,206,230,436,95,74,54,13,25,19,9,2,30,54,51.9%,35.2%
5090,3,198,144,342,73,74,31,25,13,13,11,5,29,48,50.0%,27.1%
5091,13,175,176,351,83,83,36,23,20,8,11,2,21,44,43.2%,18.2%
5091,8,247,166,413,133,75,25,20,23,17,13,2,32,62,48.4%,27.4%
5092,9,209,169,378,85,66,38,15,14,16,16,2,34,62,51.6%,25.8%
5092,4,198,194,392,90,52,35,14,15,12,7,3,22,55,34.5%,21.8%
5093,10,196,183,379,73,62,50,29,18,13,8,2,23,48,43.8%,27.1%
5093,7,199,140,339,81,77,36,18,29,15,5,1,21,45,44.4%,33.3%
5094,18,210,139,349,64,86,41,23,19,13,15,3,31,64,43.8%,20.3%
5094,15,211,156,367,92,68,54,19,23,12,8,2,22,42,47.6%,28.6%
5095,1,209,163,372,97,47,31,18,24,13,13,2,28,58,44.8%,22.4%
5095,5,241,143,384,111,59,25,24,17,19,10,5,34,58,50.0%,32.8%
5096,16,215,217,432,104,57,42,11,16,17,14,2,33,44,70.5%,38.6%
5096,11,157,194,351,73,56,25,16,11,9,8,0,17,43,39.5%,20.9%
5097,18,207,163,370,93,64,38,25,17,12,7,0,19,44,43.2%,27.3%
5097,5,168,184,352,59,83,34,17,24,16,7,2,25,39,59.0%,41.0%
5098,4,205,183,388,93,85,48,22,22,14,10,1,25,47,51.1%,29.8%
5098,11,213,172,385,95,78,28,22,22,17,13,2,32,69,43.5%,24.6%
5099,14,184,180,364,79,77,50,25,27,12,11,2,25,55,41.8%,21.8%
5099,8,190,134,324,80,88,39,27,25,11,13,4,28,56,42.9%,19.6%
5100,9,215,158,373,126,72,33,17,11,10,2,3,15,40,30.0%,25.0%
5100,7,223,187,410,120,60,27,11,17,11,11,2,24,58,37.9%,19.0%
5101,2,222,185,407,117,58,22,13,21,15,8,2,25,58,39.7%,25.9%
5101,16,193,132,325,89,69,41,21,12,11,12,3,26,51,45.1%,21.6%
5102,10,220,212,432,117,74,48,22,21,12,12,1,25,52,46.2%,23.1%
5102,15,169,116,285,66,68,37,21,22,7,9,4,20,50,32.0%,14.0%
5103,13,212,127,339,103,72,41,16,18,19,7,1,27,51,51.0%,37.3%
5103,3,186,187,373,75,70,30,18,15,14,16,3,33,59,50.8%,23.7%
5104,12,200,195,395,92,42,36,22,19,8,9,1,18,53,32.1%,15.1%
5104,1,239,174,413,121,53,33,19,22,20,5,1,26,55,45.5%,36.4%
5105,3,170,154,324,84,91,27,26,21,9,15,4,28,42,57.1%,21.4%
5105,12,181,149,330,73,79,43,21,26,23,9,2,34,61,52.5%,37.7%
5106,15,233,258,491,131,62,32,13,16,19,6,3,28,56,44.6%,33.9%
5106,16,172,184,356,86,63,19,16,13,10,7,2,19,53,32.1%,18.9%
5107,10,216,168,384,107,47,42,22,25,19,12,3,34,49,63.3%,38.8%
5107,8,176,112,288,84,52,43,25,22,13,7,0,20,43,46.5%,30.2%
5108,4,188,164,352,80,64,25,24,12,9,8,3,20,47,36.2%,19.1%
5108,9,217,157,374,113,73,35,12,24,10,8,2,20,45,40.0%,22.2%
5109,14,181,185,366,99,85,43,19,23,12,9,4,25,37,56.8%,32.4%
5109,5,227,131,358,92,90,40,23,19,14,18,5,37,66,48.5%,21.2%
5110,7,253,235,488,147,65,37,17,20,23,11,2,36,58,58.6%,39.7%
5110,18,155,149,304,69,43,23,21,17,8,8,1,17,37,43.2%,21.6%
5111,13,198,162,360,88,65,42,21,18,16,12,1,29,47,59.6%,34.0%
5111,2,189,147,336,90,53,25,18,21,11,12,2,25,58,39.7%,19.0%
5112,11,227,180,407,106,83,36,14,19,7,8,3,18,53,28.3%,13.2%
5112,1,219,149,368,78,70,42,19,14,8,10,3,21,50,36.0%,16.0%
5113,1,248,192,440,147,87,29,18,8,6,8,2,16,44,31.8%,13.6%
5113,7,202,221,423,90,77,35,8,17,7,6,1,14,41,31.7%,17.1%
5114,15,192,171,363,81,70,26,25,22,15,13,1,29,53,52.8%,28.3%
5114,13,212,220,432,122,58,32,23,25,12,5,1,18,47,36.2%,25.5%
5115,11,191,146,337,100,81,43,18,21,10,14,0,24,46,52.2%,21.7%
5115,18,198,137,335,99,80,46,21,18,14,10,3,27,51,47.1%,27.5%
5116,3,242,169,411,124,107,38,30,16,15,12,4,31,58,46.6%,25.9%
5116,8,169,136,305,83,69,36,16,30,9,8,1,18,58,29.3%,15.5%
5117,10,196,136,332,81,65,33,16,18,16,10,1,27,52,50.0%,30.8%
5117,9,186,112,298,77,78,37,18,16,13,8,1,22,45,46.7%,28.9%
5118,14,229,223,452,112,72,50,22,15,24,17,0,41,63,65.1%,38.1%
5118,2,162,200,362,73,61,23,15,22,7,9,2,18,43,37.2%,16.3%
5119,12,190,231,421,87,59,43,13,9,16,6,0,22,48,45.8%,33.3%
5119,5,209,158,367,77,88,42,9,13,24,10,1,35,63,54.0%,38.1%
5120,4,175,168,343,57,73,57,24,14,10,12,1,23,49,44.9%,20.4%
5120,16,178,153,331,65,106,40,14,24,17,6,3,26,48,47.9%,35.4%
5121,11,219,172,391,118,42,22,21,20,11,6,2,19,50,34.0%,22.0%
5121,14,209,210,419,124,59,37,20,21,9,6,3,18,42,35.7%,21.4%
5122,5,222,162,384,124,77,37,15,20,15,7,3,25,43,51.2%,34.9%
5122,7,206,181,387,115,54,36,20,15,6,15,1,22,38,55.3%,15.8%
5123,8,221,213,434,94,86,31,20,16,17,16,0,33,64,51.6%,26.6%
5123,9,147,133,280,66,79,48,16,20,7,0,1,8,25,28.0%,28.0%
5124,3,204,158,362,95,59,20,24,19,14,12,4,30,55,47.3%,25.5%
5124,4,216,180,396,111,55,34,19,24,20,9,3,32,59,49.2%,33.9%
5125,1,248,187,435,134,63,24,14,20,12,7,4,23,53,35.8%,22.6%
5125,18,202,141,343,99,42,24,20,13,7,4,1,12,41,26.8%,17.1%
5126,12,173,147,320,87,82,38,13,18,10,6,2,18,52,30.8%,19.2%
5126,10,213,179,392,109,82,42,18,13,16,9,2,27,45,55.6%,35.6%
5127,2,188,128,316,60,82,40,12,21,7,7,4,18,53,26.4%,13.2%
5127,15,210,168,378,84,85,47,21,12,15,13,0,28,49,57.1%,30.6%
5128,16,183,149,332,86,72,37,23,16,11,14,2,27,54,46.3%,20.4%
5128,13,203,154,357,108,77,35,16,23,10,10,1,21,44,45.5%,22.7%
5129,11,193,199,392,100,55,33,15,19,9,7,4,20,50,32.0%,18.0%
5129,7,206,263,469,115,69,37,19,15,5,6,1,12,34,32.4%,14.7%
5130,9,184,136,320,86,55,37,19,24,10,7,1,18,40,42.5%,25.0%
5130,10,215,166,381,106,53,42,24,19,16,7,3,26,55,41.8%,29.1%
5131,16,199,167,366,94,64,44,24,21,13,8,7,28,59,35.6%,22.0%
5131,12,177,155,332,75,90,35,21,24,13,6,3,22,44,43.2%,29.5%
5132,14,230,220,450,130,63,28,21,24,16,13,3,32,47,61.7%,34.0%
5132,4,185,142,327,92,55,22,24,21,10,8,0,18,47,38.3%,21.3%
5133,8,178,168,346,74,84,45,15,19,15,8,0,23,44,52.3%,34.1%
5133,5,215,154,369,86,78,48,19,15,13,15,2,30,47,59.6%,27.7%
5134,13,217,142,359,111,63,39,16,17,15,10,3,28,60,41.7%,25.0%
5134,15,188,242,430,85,54,26,17,16,17,8,3,28,53,47.2%,32.1%
5135,2,194,161,355,92,54,27,12,16,16,13,3,32,57,50.9%,28.1%
5135,18,188,133,321,87,64,42,16,12,18,13,1,32,52,59.6%,34.6%
5136,1,240,175,415,134,60,26,19,20,17,4,1,22,53,39.6%,32.1%
5136,3,187,191,378,87,68,29,20,18,11,10,2,23,49,42.9%,22.4%
5137,14,186,165,351,68,56,43,16,16,11,12,1,24,49,46.9%,22.4%
5137,7,211,141,352,96,73,38,16,16,12,9,2,23,41,51.2%,29.3%
5138,16,216,113,329,112,57,34,27,19,14,9,1,24,42,54.8%,33.3%
5138,8,197,148,345,98,60,42,19,27,8,10,6,24,52,34.6%,15.4%
5139,5,263,156,419,112,55,16,16,14,17,15,7,39,68,47.1%,25.0%
5139,1,204,154,358,71,58,61,14,16,8,11,3,22,51,37.3%,15.7%
5140,10,173,177,350,55,92,40,15,20,14,13,2,29,51,52.9%,27.5%
5140,12,191,128,319,67,73,68,20,15,13,15,1,29,61,45.9%,21.3%
5141,14,239,245,484,118,66,31,16,12,20,11,4,35,68,45.6%,29.4%
5141,16,190,97,287,106,65,37,12,16,10,5,1,16,43,34.9%,23.3%
5142,1,195,126,321,92,55,36,25,20,11,7,4,22,53,34.0%,20.8%
5142,10,196,161,357,101,57,30,20,25,10,8,4,22,44,40.9%,22.7%
5143,5,228,101,329,111,77,31,13,13,18,12,0,30,56,53.6%,32.1%
5143,14,179,229,408,82,73,36,14,12,11,11,2,24,45,48.9%,24.4%
5144,7,226,141,367,102,79,34,14,21,13,8,2,23,49,42.9%,26.5%
5144,1,201,150,351,74,49,41,21,14,8,11,5,24,49,38.8%,16.3%
5146,5,250,129,379,121,87,49,16,13,16,8,4,28,55,43.6%,29.1%
5146,7,178,148,326,84,67,26,13,16,7,9,1,17,39,41.0%,17.9%
5147,12,230,143,373,103,80,43,22,27,14,16,4,34,69,43.5%,20.3%
5147,2,189,127,316,70,57,26,27,21,13,4,2,19,37,45.9%,35.1%
5148,14,219,209,428,103,49,36,28,25,6,6,6,18,54,22.2%,11.1%
5148,7,216,118,334,92,78,29,25,28,6,9,2,17,52,28.8%,11.5%
5149,5,234,164,398,84,83,37,26,20,24,8,3,35,70,45.7%,34.3%
5149,18,192,139,331,71,69,35,20,26,12,6,2,20,50,36.0%,24.0%
5150,9,200,143,343,88,59,35,23,18,14,8,0,22,50,44.0%,28.0%
5150,16,184,167,351,60,59,46,18,23,13,13,3,29,57,45.6%,22.8%
5151,11,227,139,366,114,51,31,26,17,16,9,0,25,59,42.4%,27.1%
5151,8,202,170,372,84,62,36,17,26,12,11,2,25,54,42.6%,22.2%
5152,3,244,169,413,116,66,30,28,17,16,14,3,33,71,42.3%,22.5%
5152,1,194,123,317,70,60,26,17,28,8,9,1,18,40,42.5%,20.0%
5153,13,209,132,341,92,59,38,22,18,11,18,0,29,51,56.9%,21.6%
5153,10,187,118,305,75,80,27,18,22,11,16,2,29,55,49.1%,20.0%
5154,4,197,172,369,80,53,50,18,30,13,11,3,27,55,43.6%,23.6%
5154,15,216,137,353,108,47,18,30,18,13,9,1,23,48,45.8%,27.1%
5155,7,200,119,319,77,72,41,26,26,13,16,1,30,51,56.9%,25.5%
5155,2,172,141,313,52,74,42,26,26,14,9,2,25,51,45.1%,27.5%
5156,15,186,172,358,78,60,38,23,20,7,12,2,21,54,35.2%,13.0%
5156,5,256,191,447,108,71,28,21,22,21,15,2,38,72,50.0%,29.2%
5157,18,176,130,306,53,89,17,28,25,15,8,0,23,52,44.2%,28.8%
5157,4,198,169,367,80,63,53,25,28,16,18,2,36,56,60.7%,28.6%
5158,19,174,158,332,66,57,33,19,21,7,9,1,17,41,39.0%,17.1%
5158,12,268,171,439,123,53,47,21,19,26,15,0,41,63,65.1%,41.3%
5159,16,202,145,347,99,46,42,28,20,10,14,4,28,55,43.6%,18.2%
5159,14,219,169,388,106,63,18,21,28,13,9,2,24,47,46.8%,27.7%
5160,1,220,221,441,86,80,24,19,16,19,7,2,28,50,52.0%,38.0%
5160,9,178,184,362,79,68,43,16,19,6,7,2,15,52,25.0%,11.5%
5161,10,204,124,328,86,86,35,35,20,14,9,5,28,59,39.0%,23.7%
5161,3,184,126,310,71,61,44,20,35,13,12,3,28,48,52.1%,27.1%
5162,8,256,197,453,130,49,19,20,20,16,19,7,42,75,46.7%,21.3%
5162,13,184,125,309,87,40,40,20,20,12,5,0,17,35,48.6%,34.3%
5163,5,226,139,365,99,55,26,19,20,15,10,2,27,55,45.5%,27.3%
5163,12,210,127,337,106,56,38,20,19,11,7,1,19,45,40.0%,24.4%
5164,1,236,174,410,118,51,33,20,14,18,12,2,32,63,47.6%,28.6%
5164,19,194,144,338,99,56,28,14,19,7,6,3,16,42,31.0%,16.7%
5165,11,197,177,374,87,52,31,19,20,7,11,1,19,54,33.3%,13.0%
5165,16,206,199,405,92,68,31,20,19,11,12,1,24,53,43.4%,20.8%
5166,2,199,100,299,37,75,34,28,24,6,11,5,22,53,32.1%,11.3%
5166,8,227,149,376,65,88,47,24,28,17,12,1,30,51,56.9%,33.3%
5167,4,175,149,324,73,69,68,22,20,13,8,2,23,43,48.8%,30.2%
5167,10,194,118,312,64,111,38,20,22,15,11,0,26,38,68.4%,39.5%
5168,13,209,156,365,92,58,48,21,23,12,8,2,22,56,35.7%,21.4%
5168,9,229,135,364,114,67,38,23,21,11,5,0,16,53,30.2%,20.8%
5169,14,233,251,484,121,55,25,21,23,17,18,2,37,72,48.6%,23.6%
5169,18,194,162,356,85,58,24,23,21,6,6,1,13,36,33.3%,16.7%
5170,7,192,189,381,89,58,28,19,19,12,10,2,24,48,45.8%,25.0%
5170,3,224,119,343,87,66,56,19,19,21,8,2,31,62,46.8%,33.9%
5171,2,201,153,354,102,59,47,17,23,13,9,3,25,45,48.9%,28.9%
5171,5,255,123,378,106,57,22,23,17,24,13,4,41,63,58.7%,38.1%
5172,8,197,162,359,94,84,28,13,15,10,12,0,22,49,44.9%,20.4%
5172,4,201,157,358,88,76,49,15,13,9,7,4,20,46,34.8%,19.6%
5173,12,197,150,347,88,87,46,19,20,11,8,5,24,51,37.3%,21.6%
5173,3,195,133,328,85,77,36,20,19,11,11,2,24,54,40.7%,20.4%
5174,10,202,120,322,37,100,42,26,17,7,8,4,19,52,28.8%,13.5%
5174,14,206,125,331,76,82,50,17,26,11,12,3,26,55,41.8%,20.0%
5175,18,222,152,374,99,54,21,31,26,14,9,5,28,53,43.4%,26.4%
5175,11,201,187,388,106,69,29,26,31,9,9,3,21,42,42.9%,21.4%
5176,19,173,147,320,67,54,24,20,21,9,13,2,24,40,55.0%,22.5%
5176,13,239,165,404,106,67,48,21,20,23,20,1,44,66,65.2%,34.8%
5177,16,195,156,351,69,79,42,23,16,18,17,2,37,57,61.4%,31.6%
5177,15,167,207,374,50,74,39,15,24,14,10,4,28,55,43.6%,25.5%
5178,9,196,163,359,63,87,53,21,17,11,10,0,21,54,38.9%,20.4%
5178,7,214,156,370,79,75,28,17,21,13,10,1,24,50,46.0%,26.0%
5179,18,209,123,332,98,70,23,26,15,15,9,2,26,54,44.4%,27.8%
5179,19,176,172,348,58,53,44,15,26,15,12,2,29,52,51.9%,28.8%
5180,12,208,192,400,90,74,38,22,14,11,13,6,30,54,44.4%,20.4%
5180,11,163,174,337,84,55,34,14,22,12,3,4,19,42,35.7%,28.6%
5181,15,190,145,335,56,84,36,27,19,14,15,4,33,58,50.0%,24.1%
5181,2,216,179,395,105,67,32,19,27,17,9,1,27,55,47.3%,30.9%
5182,3,204,167,371,59,91,35,24,16,11,8,3,22,56,33.9%,19.6%
5182,5,252,151,403,97,78,48,16,24,16,8,3,27,58,41.4%,27.6%
5183,16,204,171,375,85,69,59,17,24,12,9,4,25,57,36.8%,21.1%
5183,1,209,165,374,64,67,26,24,17,11,10,2,23,52,40.4%,21.2%
5184,8,197,175,372,77,59,33,23,20,15,8,0,23,58,39.7%,25.9%
5184,14,233,178,411,119,65,41,20,21,17,13,2,32,57,52.6%,29.8%
5185,4,236,153,389,122,68,35,18,12,15,11,5,31,65,40.0%,23.1%
5185,13,181,168,349,92,57,34,12,18,6,14,2,22,36,55.6%,16.7%
5186,10,190,105,295,39,88,65,24,21,10,8,3,21,55,32.7%,18.2%
5186,12,235,129,364,47,106,41,22,24,12,12,3,27,58,41.4%,20.7%
5187,15,218,179,397,107,60,43,20,25,18,22,3,43,75,53.3%,24.0%
5187,18,195,122,317,84,38,22,25,19,10,12,1,23,40,55.0%,25.0%
5188,2,226,194,420,94,70,37,21,18,18,14,2,34,67,47.8%,26.9%
5188,9,175,169,344,70,57,38,18,21,14,11,3,28,53,47.2%,26.4%
5189,11,217,121,338,102,61,53,27,31,13,9,3,25,46,47.8%,28.3%
5189,7,186,141,327,73,60,35,31,27,9,13,4,26,44,50.0%,20.5%
5190,3,245,212,457,106,58,40,21,25,31,10,1,42,65,63.1%,47.7%
5190,19,161,155,316,57,70,28,25,21,8,10,0,18,48,37.5%,16.7%
5191,5,242,148,390,69,63,38,17,12,15,13,2,30,70,40.0%,21.4%
5191,1,210,112,322,69,74,65,13,17,8,9,0,17,42,40.5%,19.0%
5192,18,200,139,339,97,46,33,27,14,10,9,3,22,36,52.8%,27.8%
5192,8,230,147,377,135,49,32,14,27,15,12,2,29,47,57.4%,31.9%
5193,1,229,179,408,108,57,39,15,24,10,5,0,15,54,27.8%,18.5%
5193,10,194,158,352,65,69,39,24,15,10,11,2,23,55,38.2%,18.2%
5194,14,230,180,410,114,40,29,15,24,19,11,2,32,57,52.6%,33.3%
5194,15,190,165,355,95,62,31,24,15,9,6,1,16,49,30.6%,18.4%
5195,2,212,169,381,102,57,17,21,24,23,9,1,33,54,59.3%,42.6%
5195,16,167,132,299,58,48,46,24,21,14,11,4,29,54,46.3%,25.9%
5196,19,206,122,328,71,66,28,27,11,18,14,2,34,62,51.6%,29.0%
5196,9,177,156,333,68,67,63,11,27,17,12,2,31,45,64.4%,37.8%
5197,3,206,149,355,90,71,24,20,35,16,9,1,26,47,53.2%,34.0%
5197,4,187,128,315,71,64,61,35,20,12,13,5,30,58,43.1%,20.7%
5198,13,232,172,404,95,83,55,18,21,22,14,3,39,73,49.3%,30.1%
5198,11,184,133,317,79,61,45,21,18,8,5,0,13,42,31.0%,19.0%
5199,7,193,137,330,93,86,36,16,14,12,7,2,21,52,36.5%,23.1%
5199,12,231,159,390,102,75,51,14,15,11,13,5,29,54,44.4%,20.4%
5200,14,221,135,356,93,82,44,24,21,8,12,5,25,62,32.3%,12.9%
5200,5,223,130,353,84,60,24,21,24,9,5,3,17,42,33.3%,21.4%
5201,15,208,159,367,92,70,43,30,20,19,7,3,29,54,48.1%,35.2%
5201,13,197,129,326,92,73,36,20,30,12,9,2,23,48,43.8%,25.0%
5202,11,217,204,421,110,70,51,21,15,20,8,2,30,56,50.0%,35.7%
5202,19,172,184,356,68,83,32,15,20,9,14,5,28,49,46.9%,18.4%
5203,9,188,148,336,71,71,44,17,25,9,11,1,21,36,55.6%,25.0%
5203,3,234,153,387,91,59,33,25,17,15,11,1,27,75,34.7%,20.0%
5204,10,216,155,371,80,67,38,12,15,18,9,4,31,61,44.3%,29.5%
5204,18,199,149,348,85,64,44,15,12,9,3,2,14,39,30.8%,23.1%
5205,8,273,147,420,157,78,44,23,23,14,11,4,29,59,42.4%,23.7%
5205,7,165,143,308,70,56,37,23,23,10,5,4,19,31,48.4%,32.3%
5206,1,203,179,382,68,71,34,19,15,23,12,3,38,63,55.6%,36.5%
5206,2,195,174,369,97,56,36,15,19,18,7,3,28,57,43.9%,31.6%
5207,4,213,122,335,99,82,39,27,14,14,11,1,26,51,49.0%,27.5%
5207,16,162,146,308,76,105,48,14,27,9,6,3,18,30,50.0%,30.0%
5208,12,228,133,361,112,75,39,24,15,14,11,5,30,56,44.6%,25.0%
5208,14,177,174,351,84,57,41,15,24,15,11,1,27,45,57.8%,33.3%
5209,7,195,210,405,85,58,40,20,25,16,9,1,26,58,43.1%,27.6%
5209,13,219,193,412,108,68,42,25,20,13,5,3,21,52,34.6%,25.0%
5210,18,183,137,320,82,59,33,17,21,14,6,0,20,43,46.5%,32.6%
5210,16,217,198,415,114,76,39,21,17,21,11,5,37,54,59.3%,38.9%
5211,9,236,95,331,86,66,29,28,16,10,11,2,23,57,36.8%,17.5%
5211,15,221,131,352,67,62,30,16,28,8,9,2,19,53,32.1%,15.1%
5212,2,201,173,374,77,83,39,20,23,16,8,1,25,47,51.1%,34.0%
5212,3,195,121,316,60,76,54,23,20,13,7,4,24,59,33.9%,22.0%
5213,5,230,139,369,99,65,29,15,15,20,12,3,35,67,47.8%,29.9%
5213,11,189,128,317,70,61,63,15,15,14,8,0,22,44,50.0%,31.8%
5214,10,171,143,314,65,69,36,20,23,8,10,2,20,49,36.7%,16.3%
5214,8,238,179,417,105,65,45,24,20,15,14,2,31,51,56.9%,29.4%
5215,4,218,226,444,92,81,50,24,17,26,18,1,45,65,67.7%,40.0%
5215,1,146,177,323,57,74,32,17,24,8,3,1,12,31,35.5%,25.8%
5216,13,178,149,327,75,69,44,12,18,6,10,0,16,38,42.1%,15.8%
5216,12,247,142,389,128,81,43,18,12,13,12,3,28,52,48.1%,25.0%
5217,15,182,148,330,56,69,63,22,20,9,15,2,26,53,45.3%,17.0%
5217,10,218,133,351,102,81,23,20,22,10,10,2,22,48,41.7%,20.8%
5218,5,229,165,394,90,71,23,18,19,16,7,2,25,52,44.2%,30.8%
5218,4,194,159,353,77,61,55,19,18,7,7,4,18,50,28.0%,14.0%
5219,16,185,144,329,78,89,52,19,9,7,14,0,21,45,46.7%,15.6%
5219,7,188,169,357,76,77,52,9,19,15,11,1,27,46,56.5%,32.6%
5220,19,183,164,347,66,60,41,22,9,10,12,1,23,47,46.8%,21.3%
5220,14,239,175,414,122,65,36,9,21,21,11,2,34,67,47.8%,31.3%
5221,2,199,163,362,67,61,32,16,29,10,12,2,24,56,39.3%,17.9%
5221,18,217,99,316,67,89,47,29,16,13,9,2,24,57,38.6%,22.8%
5222,11,200,151,351,79,63,54,24,15,8,13,0,21,55,38.2%,14.5%
5222,9,213,143,356,98,77,46,15,24,15,11,0,26,45,57.8%,33.3%
5223,1,159,140,299,61,63,30,23,23,9,7,1,17,41,39.0%,22.0%
5223,8,283,156,439,180,65,42,23,23,13,10,3,26,52,44.2%,25.0%
5224,3,215,137,352,93,51,39,10,19,10,7,1,18,60,28.3%,16.7%
5224,13,236,198,434,119,78,34,19,10,15,9,2,26,45,53.3%,33.3%
5225,14,228,157,385,114,70,36,26,28,23,9,1,33,63,50.8%,36.5%
5225,1,172,136,308,69,72,31,28,26,13,6,3,22,41,46.3%,31.7%
5226,4,235,145,380,126,86,53,20,20,13,7,0,20,45,44.4%,28.9%
5226,19,183,156,339,74,73,23,20,20,10,6,1,17,47,34.0%,21.3%
5227,9,167,106,273,70,58,44,17,21,7,5,4,16,38,31.6%,18.4%
5227,10,262,146,408,128,72,27,21,17,17,13,1,31,60,50.0%,28.3%
5228,5,227,128,355,97,97,50,23,18,16,10,2,28,60,43.3%,26.7%
5228,7,203,155,358,96,69,41,18,23,7,6,3,16,38,34.2%,18.4%
5229,8,207,162,369,80,55,46,13,14,17,8,1,26,54,46.3%,31.5%
5229,16,182,144,326,71,81,41,14,13,13,9,2,24,48,45.8%,27.1%
5230,15,222,144,366,101,73,52,22,13,18,5,2,25,58,39.7%,31.0%
5230,11,173,133,306,78,68,51,13,22,10,8,0,18,34,52.9%,29.4%
5231,18,180,148,328,73,56,24,21,18,7,6,1,14,35,37.1%,20.0%
5231,12,256,178,434,109,49,39,18,21,16,14,1,31,58,51.7%,27.6%
5232,7,203,167,370,91,91,34,19,20,12,7,2,21,45,42.2%,26.7%
5232,1,178,196,374,68,71,40,20,19,8,8,1,17,42,38.1%,19.0%
5233,11,175,162,337,81,51,39,16,22,10,6,1,17,46,34.8%,21.7%
5233,4,226,144,370,106,60,58,22,16,15,11,5,31,60,43.3%,25.0%
5234,19,191,144,335,52,59,28,21,15,9,7,2,18,51,31.4%,17.6%
5234,15,234,190,424,95,66,42,15,21,18,13,1,32,58,53.4%,31.0%
5235,14,215,124,339,98,80,51,25,18,13,7,3,23,52,38.5%,25.0%
5235,8,213,181,394,98,83,37,18,25,13,5,0,18,38,47.4%,34.2%
5236,12,231,199,430,113,78,35,15,13,19,9,1,29,59,47.5%,32.2%
5236,9,172,162,334,72,73,39,13,15,9,8,1,18,43,39.5%,20.9%
5237,10,193,119,312,72,90,43,22,18,9,17,4,30,49,53.1%,18.4%
5237,2,188,153,341,79,82,49,18,22,9,8,3,20,50,34.0%,18.0%
5238,16,215,182,397,103,88,44,17,19,15,7,1,23,45,48.9%,33.3%
5238,3,164,159,323,53,77,48,19,17,9,6,4,19,50,30.0%,18.0%
5239,13,183,172,355,90,70,50,15,21,6,4,1,11,34,29.4%,17.6%
5239,5,226,168,394,91,67,26,21,15,19,13,2,34,74,43.2%,25.7%
5240,1,208,158,366,79,68,25,29,18,14,14,2,30,56,50.0%,25.0%
5240,11,203,129,332,113,56,34,18,29,10,8,2,20,47,38.3%,21.3%
5241,8,261,197,458,141,61,38,17,16,19,11,4,34,61,49.2%,31.1%
5241,19,184,152,336,82,51,16,16,17,8,7,3,18,33,45.5%,24.2%
5242,3,201,129,330,78,65,41,21,27,12,17,1,30,60,48.3%,20.0%
5242,15,203,134,337,68,71,37,27,21,17,8,1,26,55,45.5%,30.9%
5243,9,177,138,315,85,43,36,29,24,14,7,3,24,51,41.2%,27.5%
5243,2,199,132,331,91,54,24,25,29,18,16,1,35,60,56.7%,30.0%
5244,7,183,182,365,81,68,51,21,16,11,6,0,17,46,37.0%,23.9%
5244,14,211,158,369,103,45,40,17,21,15,8,2,25,54,42.6%,27.8%
5245,13,215,182,397,96,53,34,18,15,22,14,3,39,57,63.2%,38.6%
5245,16,160,166,326,71,60,36,15,18,8,10,2,20,45,40.0%,17.8%
5246,12,216,142,358,95,88,35,24,11,15,8,2,25,42,54.8%,35.7%
5246,10,190,134,324,87,70,45,11,24,10,6,0,16,46,34.8%,21.7%
5247,4,215,164,379,79,65,51,15,20,15,15,5,35,57,52.6%,26.3%
5247,18,216,131,347,90,82,27,20,15,13,9,1,23,40,55.0%,32.5%
5248,8,254,182,436,141,71,34,16,19,23,7,1,31,57,52.6%,40.4%
5248,3,175,177,352,71,61,45,19,15,12,5,4,21,44,38.6%,27.3%
5249,19,199,137,336,79,64,30,20,19,13,9,1,23,52,42.3%,25.0%
5249,1,207,183,390,91,77,50,19,20,17,5,3,25,46,47.8%,37.0%
5250,2,201,171,372,75,72,29,17,20,13,10,3,26,47,48.9%,27.7%
5250,13,179,179,358,57,91,46,20,17,17,10,6,33,63,42.9%,27.0%
5251,10,186,144,330,71,74,49,19,23,14,5,4,23,42,45.2%,33.3%
5251,5,194,130,324,84,73,31,23,19,13,20,1,34,58,56.9%,22.4%
5252,16,192,158,350,84,74,37,24,19,12,15,1,28,50,54.0%,24.0%
5252,9,203,138,341,99,71,27,19,24,10,5,0,15,38,39.5%,26.3%
5253,14,237,181,418,106,67,33,24,21,19,10,1,30,53,54.7%,35.8%
5253,11,208,153,361,86,55,51,21,24,10,11,2,23,55,38.2%,18.2%
5254,12,201,157,358,88,72,31,23,13,10,5,2,17,49,30.6%,20.4%
5254,4,197,142,339,102,75,40,13,23,15,11,2,28,58,44.8%,25.9%
5255,18,206,146,352,106,68,31,27,20,14,5,2,21,52,36.5%,26.9%
5255,15,211,141,352,74,58,56,20,26,21,9,1,31,58,51.7%,36.2%
5256,1,224,156,380,101,75,43,15,14,19,10,3,32,57,50.9%,33.3%
5256,13,170,175,345,73,72,56,14,15,8,11,4,23,47,40.4%,17.0%
5257,2,173,134,307,84,49,33,16,17,12,8,1,21,40,50.0%,30.0%
5257,12,208,150,358,87,66,66,17,17,28,14,2,44,67,62.7%,41.8%
5258,16,215,164,379,102,76,45,24,16,17,9,1,27,57,45.6%,29.8%
5258,19,190,153,343,76,67,33,16,23,9,7,1,17,39,41.0%,23.1%
5259,3,216,195,411,100,76,46,19,25,18,7,0,25,44,56.8%,40.9%
5259,14,178,120,298,65,92,43,25,19,16,13,2,31,59,49.2%,27.1%
5260,11,227,130,357,59,84,53,20,18,8,8,1,17,47,34.0%,17.0%
5260,10,193,124,317,42,85,37,19,20,6,9,5,20,46,32.6%,13.0%
5261,9,192,171,363,93,70,51,17,15,15,9,0,24,48,50.0%,31.2%
5261,18,197,149,346,95,65,32,15,17,13,8,2,23,41,51.2%,31.7%
5262,5,216,170,386,90,81,29,19,15,15,12,4,31,59,45.8%,25.4%
5262,8,230,179,409,118,57,40,15,19,9,10,1,20,44,43.2%,20.5%
5263,15,167,130,297,45,71,50,24,16,10,10,0,20,53,37.7%,18.9%
5263,7,227,167,394,122,75,28,17,24,12,5,2,19,47,36.2%,25.5%
5264,4,204,152,356,85,70,54,23,25,14,11,1,26,43,58.1%,32.6%
5264,14,194,171,365,61,78,42,25,23,13,8,2,23,52,40.4%,25.0%
5265,8,216,181,397,106,66,38,23,22,16,9,0,25,52,48.1%,30.8%
5265,9,171,170,341,65,65,38,22,23,9,8,1,18,36,47.2%,25.0%
5266,19,194,154,348,86,71,32,19,16,4,11,1,16,39,38.5%,10.3%
5266,10,237,154,391,95,60,40,16,19,15,13,3,31,63,44.4%,23.8%
5267,3,191,143,334,92,89,52,22,25,15,12,3,30,47,57.4%,31.9%
5267,2,199,140,339,104,62,27,25,22,9,8,4,21,42,40.5%,21.4%
5268,5,252,137,389,90,84,25,19,21,22,9,6,37,66,47.0%,33.3%
5268,15,173,116,289,56,71,47,21,19,3,11,1,15,47,29.8%,6.4%
5269,18,195,146,341,98,54,39,30,18,8,4,1,13,32,37.5%,25.0%
5269,7,201,172,373,90,73,47,18,30,17,7,0,24,56,42.9%,30.4%
5270,1,197,114,311,81,83,34,12,16,14,9,3,26,58,39.7%,24.1%
5270,12,200,182,382,80,94,62,16,12,9,13,2,24,52,42.3%,17.3%
5271,11,212,170,382,88,73,44,27,24,10,11,2,23,60,35.0%,16.7%
5271,3,231,149,380,96,79,38,24,27,12,10,2,24,47,46.8%,25.5%
5272,2,245,151,396,141,56,26,22,21,9,13,3,25,50,44.0%,18.0%
5272,19,199,146,345,91,63,33,21,22,12,13,0,25,46,54.3%,26.1%
5273,12,196,142,338,83,51,41,20,15,11,12,1,24,47,48.9%,23.4%
5273,5,218,123,341,104,64,32,15,20,13,14,6,33,58,46.6%,22.4%
5274,7,222,183,405,96,71,19,11,19,13,3,1,17,49,32.7%,26.5%
5274,4,205,129,334,106,70,55,19,11,9,3,4,16,47,25.5%,19.1%
5275,13,198,154,352,66,74,53,13,15,17,10,1,28,56,48.2%,30.4%
5275,18,222,151,373,85,62,27,16,13,14,8,0,22,47,46.8%,29.8%
5276,10,201,127,328,64,91,66,20,22,13,5,4,22,55,32.7%,23.6%
5276,16,177,154,331,54,97,45,22,20,15,6,2,23,48,43.8%,31.2%
5277,9,210,174,384,99,63,40,17,24,15,12,2,29,41,65.9%,36.6%
5277,14,188,168,356,81,72,30,24,17,20,13,0,33,62,53.2%,32.3%
5278,15,211,166,377,82,53,44,18,19,21,15,1,37,68,52.9%,30.9%
5278,1,197,135,332,77,67,35,19,18,17,7,2,26,52,46.2%,32.7%
5279,7,245,192,437,163,83,18,18,20,19,10,3,32,48,60.4%,39.6%
5279,11,174,145,319,98,52,44,20,18,3,4,2,9,35,20.0%,8.6%
5280,15,205,137,342,99,77,43,25,15,17,15,5,37,53,60.4%,32.1%
5280,9,184,151,335,73,77,46,15,25,11,10,1,22,50,42.0%,22.0%
5281,10,238,161,399,75,79,58,15,20,16,12,6,34,74,37.8%,21.6%
5281,1,185,103,288,51,103,42,20,15,11,9,0,20,46,43.5%,23.9%
5282,19,179,184,363,75,55,37,15,17,11,9,0,20,41,48.8%,26.8%
5282,5,254,184,438,114,61,37,17,15,19,12,3,34,77,40.3%,24.7%
5283,3,187,142,329,86,60,36,21,13,12,4,3,19,40,40.0%,30.0%
5283,12,205,145,350,83,82,49,13,21,24,8,1,33,52,61.5%,46.2%
5284,14,198,200,398,99,77,24,20,24,17,8,3,28,66,37.9%,25.8%
5284,2,187,181,368,80,60,38,24,20,7,7,2,16,35,40.0%,20.0%
5285,13,186,112,298,93,77,38,21,20,12,5,1,18,39,43.6%,30.8%
5285,8,216,193,409,93,60,41,20,21,20,8,4,32,59,47.5%,33.9%
5286,16,184,120,304,81,75,18,21,25,9,7,3,19,40,40.0%,22.5%
5286,4,217,131,348,110,72,53,25,21,8,13,4,25,44,47.7%,18.2%
5287,15,183,132,315,66,80,40,19,26,9,8,0,17,41,41.5%,22.0%
5287,12,225,130,355,105,60,36,26,19,11,14,0,25,55,45.5%,20.0%
5288,1,176,136,312,60,47,33,20,21,15,3,2,20,51,35.3%,29.4%
5288,4,211,160,371,109,60,45,21,20,15,12,1,28,51,52.9%,29.4%
5289,14,251,259,510,119,91,51,26,21,37,8,3,48,69,65.2%,53.6%
5289,13,149,133,282,54,82,40,21,26,7,4,1,12,32,34.4%,21.9%
5290,19,204,161,365,82,49,28,20,12,6,14,4,24,53,37.7%,11.3%
5290,7,259,177,436,134,60,35,12,20,10,13,1,24,57,40.4%,17.5%
5291,16,190,164,354,62,82,39,32,17,6,6,2,14,34,35.3%,17.6%
5291,8,224,125,349,45,81,49,17,32,13,13,4,30,61,42.6%,21.3%
5292,5,229,175,404,91,77,43,21,17,25,13,3,41,71,53.5%,35.2%
5292,3,194,151,345,95,75,47,17,21,14,5,3,22,44,43.2%,31.8%
5293,11,216,182,398,105,58,38,20,23,16,10,5,31,61,42.6%,26.2%
5293,18,187,161,348,96,48,20,23,20,11,8,5,24,41,46.3%,26.8%
5294,7,236,176,412,120,60,54,22,17,16,12,5,33,61,45.9%,26.2%
5294,16,177,151,328,79,78,38,17,22,10,6,6,22,42,38.1%,23.8%
5295,12,218,152,370,99,65,42,20,21,21,7,1,29,52,53.8%,40.4%
5295,13,193,139,332,93,74,30,21,20,7,13,3,23,47,42.6%,14.9%
5296,14,241,225,466,113,61,36,24,14,29,12,2,43,80,51.2%,36.2%
5296,19,169,162,331,79,54,33,14,24,6,1,1,8,30,23.3%,20.0%
5297,3,228,186,414,100,67,45,21,21,15,8,2,25,57,40.4%,26.3%
5297,10,199,112,311,69,69,38,21,21,14,14,1,29,60,46.7%,23.3%
5298,18,195,119,314,57,64,35,13,15,3,0,3,6,35,8.6%,8.6%
5298,5,262,163,425,93,98,55,15,13,23,17,4,44,73,54.8%,31.5%
5299,9,216,143,359,105,83,45,14,16,16,8,1,25,42,57.1%,38.1%
5299,11,191,154,345,92,72,43,16,14,16,11,3,30,61,44.3%,26.2%
5300,8,224,118,342,64,81,61,26,25,15,10,3,28,54,46.3%,27.8%
5300,15,190,110,300,55,82,48,26,26,13,5,3,21,46,39.1%,28.3%
5301,4,200,177,377,81,71,40,30,13,22,9,6,37,60,51.7%,36.7%
5301,2,182,172,354,72,57,27,14,30,14,5,1,20,35,54.3%,40.0%
5302,7,201,155,356,87,76,45,24,15,10,9,1,20,54,35.2%,18.5%
5302,5,235,153,388,112,62,33,15,24,14,3,2,19,48,35.4%,29.2%
5303,8,260,186,446,140,77,58,29,18,31,9,2,42,68,58.8%,45.6%
5303,18,136,150,286,52,70,35,18,29,5,2,0,7,29,24.1%,17.2%
5304,16,179,156,335,87,73,42,23,15,12,12,1,25,48,50.0%,25.0%
5304,12,232,169,401,110,71,32,15,23,16,13,6,35,56,51.8%,28.6%
5305,1,192,181,373,61,57,38,21,14,15,10,1,26,65,38.5%,23.1%
5305,3,233,127,360,118,82,45,14,21,23,6,6,35,59,49.2%,39.0%
5306,9,212,150,362,94,43,52,24,16,18,11,4,33,54,53.7%,33.3%
5306,19,196,136,332,93,44,26,16,24,8,9,4,21,48,35.4%,16.7%
5307,13,213,170,383,98,67,42,16,23,9,7,1,17,44,36.4%,20.5%
5307,4,200,144,344,87,79,32,23,16,16,13,1,30,60,48.3%,26.7%
5308,2,212,166,378,81,62,34,23,13,14,10,5,29,56,42.9%,25.0%
5308,10,188,127,315,89,61,34,13,23,7,12,2,21,45,42.2%,15.6%
5309,11,208,203,411,103,66,31,16,19,12,10,3,25,54,40.7%,22.2%
5309,14,200,151,351,107,72,42,19,16,14,11,1,26,49,51.0%,28.6%
5310,12,224,125,349,106,65,41,25,19,8,15,3,26,55,41.8%,14.5%
5310,8,221,151,372,90,62,33,19,25,10,14,4,28,54,44.4%,18.5%
5311,19,161,212,373,72,72,14,12,11,9,8,2,19,42,40.5%,21.4%
5311,11,222,211,433,100,70,67,11,12,18,16,1,35,59,57.6%,30.5%
5312,4,192,136,328,64,65,55,25,17,20,13,1,34,55,60.0%,36.4%
5312,3,204,165,369,72,78,37,17,25,11,9,2,22,48,41.7%,22.9%
5313,15,235,171,406,105,68,31,13,14,21,14,3,38,66,53.0%,31.8%
5313,16,171,172,343,83,80,47,14,13,6,6,3,15,41,29.3%,14.6%
5314,5,240,152,392,89,45,31,20,19,14,15,3,32,71,40.8%,19.7%
5314,9,201,154,355,98,63,40,19,20,13,6,0,19,39,48.7%,33.3%
5315,10,205,150,355,75,72,62,33,22,10,20,3,33,67,44.8%,14.9%
5315,7,194,138,332,75,86,32,22,33,10,6,2,18,52,30.8%,19.2%
5316,18,178,169,347,80,69,53,25,20,15,5,2,22,45,44.4%,33.3%
5316,1,213,175,388,96,72,25,20,25,24,7,6,37,65,47.7%,36.9%
5317,13,194,137,331,77,73,50,20,19,17,4,4,25,49,42.9%,34.7%
5317,2,176,149,325,60,78,43,19,20,17,11,4,32,54,51.9%,31.5%
5318,16,190,208,398,83,44,51,18,27,8,3,1,12,37,29.7%,21.6%
5318,5,247,208,455,109,64,22,27,18,20,7,5,32,59,45.8%,33.9%
5319,8,273,167,440,141,44,32,16,16,16,16,1,33,65,49.2%,24.6%
5319,1,165,186,351,78,62,22,16,16,10,4,3,17,32,43.8%,31.2%
5320,14,192,174,366,58,89,58,26,23,12,13,1,26,58,43.1%,20.7%
5320,10,186,138,324,53,93,45,23,26,15,8,1,24,52,44.2%,28.8%
5321,7,222,144,366,100,50,33,23,12,19,17,4,40,59,61.0%,32.2%
5321,15,206,144,350,98,46,38,12,23,10,7,3,20,48,35.4%,20.8%
5322,9,222,122,344,75,96,42,24,15,11,10,5,26,52,40.4%,21.2%
5322,4,217,112,329,55,74,44,15,24,13,8,3,24,58,36.2%,22.4%
5323,11,207,189,396,101,68,51,18,12,15,8,1,24,49,46.9%,30.6%
5323,2,196,124,320,72,71,28,12,18,17,17,2,36,52,65.4%,32.7%
5324,13,197,153,350,85,64,49,17,17,17,6,4,27,55,41.8%,30.9%
5324,19,166,192,358,58,70,17,17,17,12,8,2,22,51,39.2%,23.5%
5325,3,200,165,365,94,84,51,25,19,17,16,2,35,54,61.1%,31.5%
5325,18,171,131,302,69,73,29,19,24,17,9,2,28,47,55.3%,36.2%
5326,1,223,159,382,105,64,31,20,20,15,13,4,32,59,47.5%,25.4%
5326,16,188,148,336,93,57,25,20,20,8,11,2,21,51,37.3%,15.7%
5327,19,198,166,364,74,63,34,21,19,14,11,2,27,59,42.4%,23.7%
5327,8,232,120,352,111,81,48,19,21,16,8,2,26,49,49.0%,32.7%
5328,10,208,167,375,75,77,41,21,22,18,9,2,29,57,47.4%,31.6%
5328,9,177,147,324,67,82,51,23,21,9,8,5,22,44,38.6%,20.5%
5329,12,252,172,424,144,42,36,21,18,9,7,5,21,46,34.8%,19.6%
5329,7,196,156,352,85,63,25,18,21,13,6,2,21,51,37.3%,25.5%
5330,2,184,118,302,57,62,29,18,23,13,12,1,26,61,41.0%,21.3%
5330,15,202,172,374,101,77,46,23,18,15,11,3,29,43,60.5%,34.9%
5331,5,201,164,365,89,72,30,22,18,8,3,2,13,35,31.4%,22.9%
5331,14,234,149,383,119,70,48,18,21,22,14,3,39,68,52.9%,32.4%
5332,18,199,135,334,82,78,37,28,13,17,6,4,27,43,53.5%,39.5%
5332,13,181,142,323,71,72,55,13,28,15,13,1,29,54,51.9%,27.8%
5333,4,238,139,377,81,79,58,27,19,22,9,4,35,59,52.5%,37.3%
5333,11,173,174,347,55,65,46,19,27,7,4,4,15,36,30.6%,19.4%
5334,14,196,103,299,61,66,45,21,20,14,12,2,28,69,37.7%,20.3%
5334,8,232,116,348,103,73,31,20,21,9,10,3,22,51,37.3%,17.6%
5335,5,234,202,436,88,73,29,23,18,12,8,2,22,53,37.7%,22.6%
5335,4,185,138,323,66,100,50,18,23,9,6,2,17,44,34.1%,20.5%
5336,7,216,171,387,95,59,33,20,19,8,8,1,17,53,30.2%,15.1%
5336,10,202,124,326,78,69,42,20,20,12,8,2,22,51,39.2%,23.5%
5337,12,224,147,371,86,67,45,18,20,21,22,1,44,62,69.4%,33.9%
5337,3,185,128,313,65,65,31,20,18,13,9,0,22,57,38.6%,22.8%
5338,8,214,151,365,81,78,58,25,21,19,8,0,27,52,51.9%,36.5%
5338,10,181,126,307,64,81,52,21,24,13,7,1,21,50,40.0%,26.0%
5339,4,189,133,322,76,83,61,29,22,15,8,3,26,48,47.9%,31.2%
5339,12,198,105,303,68,75,38,22,29,15,5,3,23,51,39.2%,29.4%
5340,5,215,129,344,88,70,26,28,26,10,7,1,18,52,32.7%,19.2%
5340,8,220,172,392,98,63,48,26,28,9,10,1,20,54,35.2%,16.7%
5341,14,222,139,361,98,69,38,17,20,17,13,2,32,66,45.5%,25.8%
5341,4,182,161,343,72,49,36,20,17,10,7,2,19,47,36.2%,21.3%
5342,5,200,132,332,65,108,52,21,18,12,9,0,21,51,41.2%,23.5%
5342,14,202,129,331,64,71,59,18,21,18,8,3,29,57,45.6%,31.6%
5343,20,210,157,367,96,63,37,24,16,5,6,1,12,28,39.3%,17.9%
5343,10,224,164,388,107,79,43,16,24,14,12,4,30,71,36.6%,19.7%
5344,2,178,142,320,58,65,38,22,20,12,8,1,21,45,44.4%,26.7%
5344,12,219,156,375,103,64,26,20,22,18,14,3,35,63,50.8%,28.6%
5345,8,206,163,369,88,75,42,16,22,20,15,2,37,57,61.4%,35.1%
5345,5,197,123,320,76,68,31,23,16,16,17,2,35,58,56.9%,27.6%
5346,13,198,100,298,65,66,38,24,19,11,10,2,23,48,43.8%,22.9%
5346,9,226,159,385,107,76,42,19,24,17,14,3,34,56,55.4%,30.4%
5347,19,190,172,362,83,48,21,16,15,10,4,4,18,43,32.6%,23.3%
5347,11,252,154,406,109,73,42,15,16,19,19,4,42,73,52.1%,26.0%
5348,16,198,166,364,76,75,43,27,23,16,7,2,25,41,56.1%,39.0%
5348,14,201,126,327,74,82,32,23,27,15,8,3,26,54,42.6%,27.8%
5349,15,184,154,338,80,53,30,26,17,15,8,4,27,54,42.6%,27.8%
5349,3,222,128,350,105,46,44,17,26,14,17,3,34,67,46.3%,20.9%
5350,1,204,180,384,81,52,31,12,19,12,11,4,27,54,42.6%,22.2%
5350,4,206,146,352,88,64,45,19,12,21,6,4,31,61,44.3%,34.4%
5351,18,192,140,332,75,70,40,32,21,13,10,1,24,50,46.0%,26.0%
5351,7,225,113,338,114,71,40,21,32,13,6,1,20,42,45.2%,31.0%
5352,9,176,132,308,58,63,35,16,20,9,6,3,18,41,36.6%,22.0%
5352,12,239,153,392,104,65,51,20,16,23,12,4,39,67,52.2%,34.3%
5353,3,220,112,332,102,80,53,24,23,16,13,2,31,63,46.0%,25.4%
5353,18,185,145,330,82,48,25,23,24,13,6,2,21,45,42.2%,28.9%
5354,10,201,148,349,63,74,25,27,14,14,8,2,24,53,41.5%,26.4%
5354,16,190,171,361,72,73,63,15,27,12,7,2,21,63,30.2%,19.0%
5355,4,253,194,447,108,69,43,32,12,25,13,3,41,77,49.4%,32.5%
5355,13,184,129,313,75,41,31,12,30,9,3,1,13,32,37.5%,28.1%
5356,11,215,145,360,102,53,41,14,17,11,14,2,27,49,51.0%,22.4%
5356,1,226,183,409,107,60,31,17,14,9,7,3,19,50,32.0%,18.0%
5357,5,207,142,349,100,51,27,18,20,12,10,3,25,53,41.5%,22.6%
5357,2,234,193,427,133,47,33,20,18,8,13,3,24,50,42.0%,16.0%
5358,15,211,294,505,88,56,41,23,19,28,13,2,43,83,49.4%,33.7%
5358,20,189,161,350,71,57,38,19,23,8,6,0,14,41,34.1%,19.5%
5359,7,244,161,405,106,82,40,19,21,21,12,1,34,57,57.9%,36.8%
5359,19,139,191,330,51,64,36,21,19,7,5,0,12,36,33.3%,19.4%
5360,14,197,126,323,64,70,39,24,29,14,3,5,22,53,32.1%,26.4%
5360,8,216,125,341,64,83,36,29,24,13,11,1,25,55,43.6%,23.6%
5361,12,241,170,411,115,54,56,17,13,18,9,5,32,58,46.6%,31.0%
5361,5,208,124,332,95,48,26,13,17,9,6,2,17,39,38.5%,23.1%
5362,2,228,199,427,114,71,31,25,15,20,10,3,33,65,46.2%,30.8%
5362,13,172,96,268,92,57,39,16,24,11,8,0,19,30,63.3%,36.7%
5363,18,226,155,381,113,50,35,23,17,12,11,0,23,39,59.0%,30.8%
5363,10,178,156,334,58,65,47,18,23,16,6,3,25,53,41.5%,30.2%
5364,16,226,158,384,106,67,60,20,20,8,13,3,24,52,40.4%,15.4%
5364,9,203,96,299,103,63,24,20,20,5,5,0,10,20,50.0%,25.0%
5365,1,185,167,352,83,54,39,17,24,5,7,3,15,50,24.0%,10.0%
5365,7,248,144,392,128,69,32,25,17,15,12,1,28,46,58.7%,32.6%
5366,19,192,160,352,52,72,34,18,25,13,7,3,23,48,41.7%,27.1%
5366,3,215,153,368,77,68,44,25,18,15,13,2,30,56,50.0%,26.8%
5367,20,183,194,377,75,46,28,18,22,10,8,1,19,45,40.0%,22.2%
5367,4,212,163,375,119,45,41,23,18,23,10,2,35,61,54.1%,37.7%
5368,8,239,168,407,140,79,41,16,15,21,12,2,35,52,63.5%,40.4%
5368,11,170,134,304,52,51,34,15,16,12,9,3,24,49,42.9%,24.5%
5369,15,186,199,385,80,62,44,16,12,20,9,2,31,57,50.9%,35.1%
5369,14,190,137,327,86,68,42,12,16,16,15,3,34,55,56.4%,29.1%
5370,7,209,156,365,86,64,28,12,12,11,11,2,24,56,39.3%,19.6%
5370,16,215,172,387,91,57,54,12,12,14,6,2,22,44,45.5%,31.8%
5371,12,186,150,336,76,72,36,16,22,11,11,2,24,54,40.7%,20.4%
5371,3,223,130,353,103,76,48,22,16,15,16,3,34,49,63.3%,30.6%
5372,5,216,164,380,91,72,44,17,19,14,10,3,27,47,51.1%,29.8%
5372,18,207,191,398,100,52,27,19,17,10,11,2,23,55,38.2%,18.2%
5373,11,225,145,370,41,76,47,18,24,13,16,2,31,56,51.8%,23.2%
5373,20,195,118,313,69,83,41,24,18,7,8,0,15,35,42.9%,20.0%
5374,9,229,201,430,90,78,42,18,15,17,6,3,26,60,38.3%,28.3%
5374,19,177,172,349,56,43,39,15,18,6,7,3,16,47,27.7%,12.8%
5375,4,213,141,354,94,48,49,33,23,5,14,7,26,45,42.2%,11.1%
5375,8,193,111,304,72,81,26,23,32,5,15,1,21,56,35.7%,8.9%
5376,14,214,159,373,97,94,40,20,17,11,9,0,20,49,40.8%,22.4%
5376,2,187,210,397,75,73,47,17,20,9,8,3,20,48,35.4%,18.8%
5377,10,195,137,332,61,64,47,18,22,17,7,4,28,57,42.1%,29.8%
5377,15,198,164,362,69,58,50,22,18,10,14,3,27,60,40.0%,16.7%
5378,13,170,106,276,60,73,58,20,20,9,12,1,22,42,50.0%,21.4%
5378,1,203,165,368,75,75,53,20,20,13,8,2,23,46,45.7%,28.3%
5379,5,233,139,372,69,85,40,10,17,11,11,3,25,60,36.7%,18.3%
5379,3,206,119,325,77,91,44,17,10,11,10,3,24,54,38.9%,20.4%
5380,16,201,156,357,95,81,32,16,14,7,11,4,22,41,43.9%,17.1%
5380,12,223,149,372,109,68,54,14,16,10,4,1,15,46,30.4%,21.7%
5381,20,189,179,368,88,47,39,24,21,9,6,2,17,37,40.5%,24.3%
5381,1,208,213,421,89,68,49,21,23,15,11,3,29,62,41.9%,24.2%
5382,15,199,196,395,77,65,50,21,12,17,19,6,42,61,59.0%,27.9%
5382,19,191,109,300,89,58,37,12,21,13,12,3,28,43,58.1%,30.2%
5383,9,201,124,325,30,111,47,30,21,4,12,5,21,54,29.6%,7.4%
5383,14,226,116,342,52,94,49,21,30,12,5,2,19,46,37.0%,26.1%
5384,13,202,136,338,47,102,69,21,22,10,5,1,16,44,34.1%,22.7%
5384,7,200,125,325,50,98,36,22,21,12,10,2,24,66,33.3%,18.2%
5385,8,178,170,348,70,73,56,12,16,10,8,1,19,41,43.9%,24.4%
5385,10,205,162,367,77,84,38,16,12,16,8,2,26,54,44.4%,29.6%
5386,2,198,150,348,104,58,30,17,21,14,11,2,27,47,53.2%,29.8%
5386,4,173,148,321,73,61,42,21,17,16,4,7,27,52,38.5%,30.8%
5387,11,221,138,359,95,65,45,17,20,16,11,3,30,61,44.3%,26.2%
5387,18,186,136,322,97,54,22,20,17,14,6,1,21,47,42.6%,29.8%
5388,1,211,182,393,89,69,50,21,11,11,8,3,22,51,37.3%,21.6%
5388,5,209,166,375,71,79,36,11,21,15,8,0,23,55,41.8%,27.3%
5389,3,279,182,461,131,76,48,18,14,19,12,3,34,68,45.6%,27.9%
5389,9,180,178,358,76,59,33,14,18,9,7,1,17,44,36.4%,20.5%
5390,14,237,206,443,115,64,30,12,15,17,14,3,34,62,50.0%,27.4%
5390,13,190,130,320,81,56,52,16,12,11,9,1,21,46,43.5%,23.9%
5391,19,216,188,404,111,60,36,13,18,14,2,1,17,44,36.4%,31.8%
5391,16,210,170,380,93,70,45,19,13,14,4,6,24,55,32.7%,25.5%
5392,10,197,136,333,67,99,28,24,15,14,8,2,24,67,32.8%,20.9%
5392,11,218,144,362,78,63,70,15,24,15,6,3,24,45,46.7%,33.3%
5393,7,194,132,326,82,62,35,19,19,13,7,3,23,45,44.4%,28.9%
5393,8,236,155,391,117,60,41,19,19,18,10,5,33,54,51.9%,33.3%
5394,12,236,140,376,122,77,47,11,14,15,18,2,35,63,52.4%,23.8%
5394,20,180,167,347,86,64,24,14,11,6,7,0,13,33,39.4%,18.2%
5395,18,177,144,321,77,66,27,25,20,8,5,1,14,38,34.2%,21.1%
5395,2,209,186,395,83,60,57,21,25,13,11,2,26,55,43.6%,23.6%
5396,4,223,129,352,95,46,40,29,15,17,16,2,35,60,55.0%,28.3%
5396,15,210,152,362,87,62,36,15,29,15,5,0,20,43,46.5%,34.9%
5397,13,182,77,259,96,67,31,20,21,6,9,4,19,36,41.7%,16.7%
5397,8,230,194,424,110,50,26,21,20,15,23,2,40,64,59.4%,23.4%
5398,20,221,154,375,108,53,28,15,10,13,13,3,29,58,44.8%,22.4%
5398,19,212,146,358,100,65,30,10,15,9,11,2,22,42,47.6%,21.4%
5399,11,224,141,365,93,65,48,19,13,19,7,1,27,47,55.3%,40.4%
5399,14,189,170,359,95,58,36,13,19,10,9,3,22,54,35.2%,18.5%
5400,2,233,184,417,114,66,37,14,13,13,9,4,26,49,44.9%,26.5%
5400,10,180,107,287,72,71,29,14,14,8,6,8,22,48,29.2%,16.7%
5401,9,173,137,310,94,49,39,13,19,8,8,2,18,38,42.1%,21.1%
5401,5,254,189,443,114,47,42,19,13,17,10,4,31,66,40.9%,25.8%
5402,3,247,143,390,111,50,32,19,18,16,14,3,33,63,47.6%,25.4%
5402,4,193,121,314,105,66,35,19,19,7,8,2,17,41,36.6%,17.1%
5403,15,179,154,333,73,77,46,14,18,12,9,2,23,48,43.8%,25.0%
5403,1,230,168,398,90,81,40,18,14,15,11,0,26,59,44.1%,25.4%
5404,16,204,203,407,84,75,56,26,17,12,13,2,27,55,45.5%,21.8%
5404,18,182,181,363,83,76,36,17,25,7,4,1,12,36,30.6%,19.4%
5405,7,223,124,347,95,66,25,24,20,19,8,0,27,47,57.4%,40.4%
5405,12,191,131,322,68,79,60,20,24,14,12,2,28,51,51.0%,27.5%
5406,5,230,168,398,97,55,34,14,18,14,10,2,26,51,47.1%,27.5%
5406,14,213,156,369,87,68,38,18,14,11,17,1,29,61,45.9%,18.0%
5407,18,191,137,328,84,70,51,21,14,14,8,3,25,42,52.4%,33.3%
5407,15,182,133,315,63,75,44,14,20,14,7,2,23,60,35.0%,23.3%
5408,8,235,164,399,106,54,25,16,18,17,15,2,34,67,47.8%,25.4%
5408,16,176,162,338,79,58,52,18,16,9,8,1,18,37,45.9%,24.3%
5409,10,229,166,395,97,82,30,21,16,21,10,2,33,71,43.7%,29.6%
5409,13,203,150,353,107,51,62,16,21,5,6,1,12,35,31.4%,14.3%
5410,1,220,134,354,66,87,44,15,13,9,14,4,27,56,41.1%,16.1%
5410,19,197,192,389,74,63,27,13,15,4,9,1,14,34,38.2%,11.8%
5411,3,219,144,363,102,54,35,15,10,19,12,2,33,48,64.6%,39.6%
5411,2,210,160,370,104,64,33,10,15,15,16,3,34,66,47.0%,22.7%
5412,9,246,186,432,128,55,31,25,17,19,16,2,37,65,53.8%,29.2%
5412,20,161,130,291,68,57,31,17,25,5,9,1,15,32,43.8%,15.6%
5413,12,155,130,285,54,79,46,9,14,8,5,2,15,41,31.7%,19.5%
5413,11,230,115,345,110,67,54,14,9,19,9,1,29,50,56.0%,38.0%
5414,4,226,137,363,128,57,49,25,16,18,11,2,31,48,60.4%,37.5%
5414,7,185,140,325,70,49,24,16,25,13,11,2,26,51,47.1%,25.5%
5415,1,195,173,368,62,60,38,16,13,11,8,1,20,48,39.6%,22.9%
5415,14,223,136,359,110,66,44,13,16,14,9,2,25,48,47.9%,29.2%
5416,2,232,198,430,93,77,42,21,13,21,9,2,32,67,44.8%,31.3%
5416,8,202,147,349,80,80,40,13,21,10,12,3,25,52,42.3%,19.2%
5417,19,171,155,326,67,72,38,13,14,10,9,1,20,47,40.4%,21.3%
5417,18,202,164,366,77,68,56,14,13,17,11,5,33,61,45.9%,27.9%
5418,7,218,144,362,93,79,46,23,21,16,15,0,31,55,56.4%,29.1%
5418,10,180,173,353,75,63,38,21,23,12,9,2,23,42,50.0%,28.6%
5419,11,205,119,324,69,77,46,18,20,6,12,1,19,49,36.7%,12.2%
5419,5,206,161,367,65,75,39,21,18,10,14,1,25,48,50.0%,20.8%
5420,20,199,141,340,78,77,24,28,21,7,8,3,18,50,30.0%,14.0%
5420,3,234,186,420,105,57,45,21,27,18,7,4,29,58,43.1%,31.0%
5421,15,212,170,382,79,45,50,18,20,17,7,3,27,60,40.0%,28.3%
5421,9,208,130,338,99,72,40,20,18,15,4,2,21,46,41.3%,32.6%
5422,12,215,195,410,82,89,52,12,13,15,13,4,32,58,48.3%,25.9%
5422,13,200,140,340,91,74,46,13,12,6,13,0,19,50,38.0%,12.0%
5423,4,242,161,403,136,67,47,19,10,11,17,1,29,64,43.8%,17.2%
5423,16,169,125,294,68,75,39,10,18,5,6,0,11,30,36.7%,16.7%
5424,7,200,154,354,84,55,12,22,15,16,12,5,33,58,48.3%,27.6%
5424,2,209,206,415,87,40,43,16,21,18,11,2,31,50,58.0%,36.0%
5425,14,230,146,376,129,65,41,26,25,19,9,3,31,49,57.1%,38.8%
5425,20,184,118,302,72,79,31,25,26,9,6,1,16,35,42.9%,25.7%
5426,8,246,131,377,98,74,61,18,15,27,11,1,39,68,55.9%,39.7%
5426,15,180,106,286,70,64,36,15,18,9,5,0,14,38,36.8%,23.7%
5427,16,209,158,367,110,60,52,14,20,12,8,2,22,47,42.6%,25.5%
5427,11,215,136,351,85,58,34,20,14,17,6,3,26,48,47.9%,35.4%
5428,18,223,132,355,79,82,41,16,11,14,10,5,29,61,39.3%,23.0%
5428,12,187,123,310,64,80,56,11,16,6,5,4,15,41,26.8%,14.6%
5429,3,212,142,354,72,69,46,15,16,6,14,2,22,64,31.2%,9.4%
5429,13,225,157,382,90,84,33,16,15,8,9,1,18,51,33.3%,15.7%
5430,9,199,144,343,98,81,29,13,20,16,5,1,22,51,41.2%,31.4%
5430,4,198,154,352,73,60,75,21,13,15,5,5,25,52,38.5%,28.8%
5431,10,240,187,427,74,59,56,15,19,20,8,4,32,63,44.4%,31.7%
5431,1,190,137,327,39,48,64,19,15,5,9,1,15,49,28.6%,10.2%
5432,5,247,181,428,104,59,32,15,16,23,8,3,34,61,50.8%,37.7%
5432,19,205,158,363,108,53,32,18,14,7,8,2,17,36,41.7%,19.4%
5433,12,193,154,347,68,50,54,26,23,11,17,2,30,54,51.9%,20.4%
5433,14,200,146,346,91,52,26,23,26,14,9,4,27,51,45.1%,27.5%
5434,2,214,150,364,53,84,61,17,24,9,9,3,21,58,31.0%,15.5%
5434,16,212,142,354,65,118,47,24,17,12,4,2,18,43,37.2%,27.9%
5435,19,173,132,305,90,47,30,13,19,7,6,1,14,31,41.9%,22.6%
5435,7,232,168,400,103,58,42,19,12,21,16,2,39,65,56.9%,32.3%
5436,3,219,149,368,75,70,53,23,13,11,13,3,27,78,30.8%,14.1%
5436,10,205,183,388,74,90,35,13,23,13,8,0,21,50,42.0%,26.0%
5437,18,183,115,298,79,68,54,15,16,9,3,5,17,41,29.3%,22.0%
5437,8,227,150,377,91,70,41,16,15,16,12,0,28,56,50.0%,28.6%
5438,13,181,127,308,87,60,38,18,18,13,8,1,22,45,46.7%,28.9%
5438,5,228,156,384,105,71,41,18,18,19,14,1,34,55,60.0%,34.5%
5439,4,199,147,346,60,81,62,23,21,10,16,3,29,55,47.3%,18.2%
5439,12,196,121,317,56,84,39,21,23,10,7,2,19,46,37.0%,21.7%
5440,11,224,149,373,87,59,63,16,16,17,9,4,30,56,46.4%,30.4%
5440,7,193,172,365,80,79,28,16,16,16,11,4,31,56,48.2%,28.6%
5441,20,193,101,294,51,87,46,27,24,12,2,0,14,35,40.0%,34.3%
5441,2,220,131,351,53,68,43,24,27,11,17,3,31,66,42.4%,16.7%
5442,19,177,188,365,68,56,38,21,14,12,8,0,20,51,39.2%,23.5%
5442,15,245,155,400,113,66,34,14,21,11,16,5,32,64,42.2%,17.2%
5443,8,219,144,363,66,97,37,26,17,19,17,4,40,71,50.7%,26.8%
5443,9,184,122,306,58,70,45,17,26,11,4,0,15,41,36.6%,26.8%
5444,1,252,164,416,122,65,34,20,21,13,15,2,30,59,47.5%,22.0%
5444,18,180,146,326,72,66,25,21,20,8,7,2,17,44,34.1%,18.2%
5445,10,202,151,353,74,64,36,22,14,12,7,1,20,47,40.4%,25.5%
5445,14,231,135,366,108,67,53,14,21,11,6,2,19,59,28.8%,18.6%
5446,1,193,168,361,80,69,47,15,8,7,11,3,21,50,36.0%,14.0%
5446,9,214,172,386,114,69,30,8,15,18,5,1,24,53,43.4%,34.0%
5447,5,209,165,374,85,60,26,14,12,12,12,1,25,43,55.8%,27.9%
5447,4,197,168,365,95,58,44,12,14,12,6,4,22,52,34.6%,23.1%
5448,16,221,139,360,96,60,25,22,14,14,3,2,19,46,37.0%,30.4%
5448,3,216,166,382,104,47,40,14,22,17,9,2,28,54,48.1%,31.5%
5449,13,223,186,409,92,65,47,17,22,20,10,5,35,74,40.5%,27.0%
5449,20,199,158,357,88,66,28,22,17,9,2,1,12,32,34.4%,28.1%
5450,15,209,143,352,98,41,37,16,13,17,16,3,36,59,55.9%,28.8%
5450,11,192,94,286,96,42,36,13,16,13,9,2,24,43,51.2%,30.2%
5451,12,211,149,360,101,59,40,20,22,10,7,3,20,44,38.6%,22.7%
5451,8,227,152,379,99,62,38,23,20,18,8,4,30,54,48.1%,33.3%
5452,5,221,158,379,75,100,53,14,21,15,13,4,32,69,40.6%,21.7%
5452,16,191,175,366,81,86,37,21,14,12,4,2,18,33,48.5%,36.4%
5453,11,197,135,332,77,58,43,11,20,17,4,0,21,47,44.7%,36.2%
5453,2,216,160,376,98,73,53,20,11,13,7,2,22,57,35.1%,22.8%
5454,4,263,193,456,142,53,52,18,15,25,15,1,41,60,66.7%,41.7%
5454,19,155,121,276,64,46,18,15,18,5,9,1,15,30,46.7%,16.7%
5455,10,221,214,435,90,77,35,17,19,19,16,2,37,62,56.5%,30.6%
5455,20,193,147,340,75,70,52,19,17,5,6,2,13,30,36.7%,16.7%
5456,3,266,139,405,150,62,37,16,15,21,13,1,35,54,63.0%,38.9%
5456,1,199,140,339,97,55,33,15,16,8,6,2,16,48,29.2%,16.7%
5457,14,203,149,352,82,70,44,15,28,14,11,4,29,63,39.7%,22.2%
5457,18,175,140,315,53,85,59,28,14,8,7,6,21,37,40.5%,21.6%
5458,9,226,172,398,113,53,29,16,14,18,11,3,32,50,58.0%,36.0%
5458,13,195,118,313,85,53,42,14,16,8,9,4,21,54,31.5%,14.8%
5459,7,206,135,341,94,55,29,25,14,15,10,3,28,53,47.2%,28.3%
5459,15,219,159,378,110,64,42,14,25,21,7,3,31,67,41.8%,31.3%
5460,5,198,136,334,101,50,42,14,17,8,9,5,22,44,38.6%,18.2%
5460,12,224,178,402,102,70,24,17,14,12,10,3,25,47,46.8%,25.5%
5461,15,186,130,316,88,62,27,22,26,13,6,0,19,44,43.2%,29.5%
5461,4,204,147,351,87,62,49,26,22,12,13,1,26,52,48.1%,23.1%
5462,13,196,122,318,96,76,33,19,22,11,9,3,23,41,48.8%,26.8%
5462,2,201,178,379,83,73,38,22,18,13,20,3,36,62,53.2%,21.0%
5463,10,201,180,381,86,60,46,24,16,16,11,3,30,58,46.6%,27.6%
5463,9,210,164,374,108,53,31,16,23,9,8,1,18,42,40.5%,21.4%
5464,18,171,112,283,77,62,23,17,15,8,8,2,18,35,45.7%,22.9%
5464,11,244,118,362,105,60,64,15,17,17,13,1,31,59,50.8%,28.8%
5465,7,238,122,360,122,63,21,22,22,21,5,2,28,56,46.4%,37.5%
5465,3,184,138,322,84,61,59,22,22,8,8,6,22,55,29.1%,14.5%
5466,8,256,198,454,132,60,28,20,24,28,21,4,53,75,65.3%,37.3%
5466,20,165,160,325,61,42,36,24,20,4,5,2,11,34,26.5%,11.8%
5467,19,188,125,313,94,37,19,23,23,13,16,2,31,45,64.4%,28.9%
5467,14,241,164,405,134,51,39,23,23,15,15,5,35,60,50.0%,25.0%
5468,16,223,125,348,105,76,48,20,15,14,10,1,25,54,44.4%,25.9%
5468,1,216,155,371,111,61,45,15,20,8,6,3,17,36,38.9%,22.2%
5469,15,200,123,323,81,46,45,16,17,24,5,0,29,54,53.7%,44.4%
5469,12,221,157,378,107,61,32,17,16,14,10,2,26,48,50.0%,29.2%
5470,13,172,144,316,69,83,41,17,23,12,9,2,23,47,44.7%,25.5%
5470,16,236,102,338,121,67,42,23,15,18,8,1,27,57,45.6%,31.6%
5471,18,196,190,386,78,43,31,19,17,11,10,1,22,45,46.7%,24.4%
5471,3,221,143,364,104,61,38,17,20,19,13,0,32,55,58.2%,34.5%
5472,2,241,150,391,118,57,23,20,22,13,8,2,23,56,37.5%,23.2%
5472,19,198,142,340,95,48,25,22,19,13,10,2,25,44,52.3%,29.5%
5473,9,196,151,347,77,57,38,13,19,14,6,2,22,53,37.7%,26.4%
5473,7,212,128,340,77,70,44,19,13,16,8,1,25,57,42.1%,28.1%
5474,14,199,148,347,75,64,30,16,16,10,14,5,29,56,42.9%,17.9%
5474,5,235,147,382,95,61,33,16,16,17,5,3,25,57,38.6%,29.8%
5475,20,177,151,328,77,53,39,21,19,8,10,1,19,45,40.0%,17.8%
5475,11,237,141,378,123,40,30,19,21,27,14,2,43,68,60.3%,39.7%
5476,1,212,135,347,109,61,41,17,17,6,6,2,14,38,31.6%,15.8%
5476,8,204,193,397,88,56,37,17,17,17,12,2,31,62,46.8%,27.4%
5477,4,210,125,335,85,68,50,25,18,10,7,2,19,48,35.4%,20.8%
5477,10,219,201,420,72,66,46,18,25,18,11,2,31,65,44.6%,27.7%
5478,14,235,144,379,108,64,26,15,14,20,10,4,34,65,46.2%,30.8%
5478,3,177,119,296,78,67,42,14,15,10,6,1,17,41,39.0%,24.4%
5479,5,212,175,387,91,65,44,19,20,13,8,5,26,47,44.7%,27.7%
5479,8,223,161,384,88,56,41,20,19,21,11,1,33,54,59.3%,38.9%
5480,11,235,152,387,98,52,24,17,17,19,8,2,29,54,50.0%,35.2%
5480,4,194,143,337,94,54,49,17,17,11,9,0,20,42,47.6%,26.2%
5481,19,208,127,335,87,48,33,26,23,5,13,5,23,47,38.3%,10.6%
5481,9,222,170,392,85,36,25,23,26,8,7,4,19,51,29.4%,15.7%
5482,13,218,137,355,88,73,34,31,25,8,7,1,16,55,27.3%,14.5%
5482,18,191,169,360,67,41,33,25,31,12,7,5,24,45,42.2%,26.7%
5483,1,215,136,351,121,58,59,18,22,12,11,1,24,44,52.3%,27.3%
5483,12,212,123,335,91,52,19,23,18,16,4,2,22,49,40.8%,32.7%
5484,10,193,166,359,79,51,61,13,15,15,12,3,30,52,51.9%,28.8%
5484,7,191,117,308,71,73,36,15,13,10,12,4,26,60,36.7%,16.7%
5485,2,213,159,372,85,55,40,23,22,14,13,2,29,50,54.0%,28.0%
5485,15,216,167,383,86,61,50,22,23,15,8,5,28,62,37.1%,24.2%
5486,16,242,126,368,119,45,34,31,23,18,22,2,42,67,59.7%,26.9%
5486,20,188,150,338,108,49,25,24,31,5,4,3,12,26,34.6%,19.2%
5487,3,185,151,336,74,45,43,19,20,12,10,4,26,50,44.0%,24.0%
5487,8,249,145,394,119,47,36,20,19,27,13,5,45,73,54.8%,37.0%
5488,14,200,161,361,87,84,53,24,15,15,12,0,27,61,44.3%,24.6%
5488,11,192,161,353,51,61,39,15,24,11,8,1,20,43,44.2%,25.6%
5489,15,206,223,429,85,61,51,22,19,19,11,2,32,62,48.4%,30.6%
5489,13,174,163,337,83,62,40,19,22,11,7,0,18,37,48.6%,29.7%
5490,20,207,207,414,107,38,43,11,16,7,10,2,19,42,40.5%,16.7%
5490,5,240,191,431,131,42,28,16,11,26,13,5,44,66,59.1%,39.4%
5491,19,192,206,398,74,61,35,25,20,8,5,1,14,37,35.1%,21.6%
5491,10,215,168,383,82,73,49,20,24,19,10,2,31,55,52.7%,34.5%
5492,12,192,131,323,49,95,54,25,25,14,8,3,25,47,46.8%,29.8%
5492,2,193,125,318,51,80,58,25,24,13,11,2,26,54,44.4%,24.1%
5493,18,176,185,361,71,59,31,27,16,6,7,5,18,43,30.2%,14.0%
5493,16,220,125,345,114,71,35,16,27,11,9,0,20,44,45.5%,25.0%
5494,7,238,161,399,122,77,36,10,14,16,16,6,38,55,58.2%,29.1%
5494,1,168,164,332,79,51,38,14,10,6,4,2,12,39,25.6%,15.4%
5495,4,223,164,387,104,67,57,23,22,28,7,0,35,68,51.5%,41.2%
5495,9,162,134,296,50,68,30,23,23,12,5,0,17,35,48.6%,34.3%
5496,8,195,133,328,64,79,56,26,14,17,10,4,31,50,54.0%,34.0%
5496,14,180,127,307,84,71,31,14,26,18,9,1,28,51,52.9%,35.3%
5497,1,182,176,358,72,73,53,19,16,8,12,1,21,57,35.1%,14.0%
5497,15,212,192,404,95,67,38,16,19,18,3,4,25,47,44.7%,38.3%
5498,20,215,160,375,107,49,36,30,25,16,9,2,27,46,54.3%,34.8%
5498,18,195,163,358,94,40,20,25,30,10,10,3,23,56,35.7%,17.9%
5499,16,227,102,329,89,72,38,22,19,17,9,2,28,56,46.4%,30.4%
5499,4,163,132,295,75,64,61,19,22,6,7,5,18,36,36.1%,16.7%
5500,9,163,144,307,70,64,40,14,18,12,11,1,24,39,59.0%,30.8%
5500,2,221,144,365,93,56,49,18,14,20,8,4,32,63,44.4%,31.7%
5501,5,215,158,373,83,63,42,25,14,12,16,3,31,58,48.3%,20.7%
5501,7,219,157,376,106,66,38,14,25,13,6,1,20,46,41.3%,28.3%
5502,13,201,158,359,107,66,32,19,18,16,11,1,28,46,58.7%,34.8%
5502,19,183,154,337,79,51,35,18,19,9,11,1,21,48,41.7%,18.8%
5503,12,218,129,347,107,75,32,25,20,10,7,4,21,51,33.3%,19.6%
5503,10,194,165,359,66,60,47,20,25,14,7,2,23,46,45.7%,30.4%
5504,11,221,95,316,100,67,45,17,17,16,5,3,24,51,41.2%,31.4%
5504,3,204,120,324,68,65,48,17,16,15,8,2,25,64,35.9%,23.4%
5505,4,195,126,321,67,54,67,32,32,16,4,2,22,53,37.7%,30.2%
5505,14,190,123,313,75,70,25,32,32,15,5,2,22,48,41.7%,31.2%
5506,7,207,167,374,90,69,50,13,17,16,8,3,27,50,48.0%,32.0%
5506,13,185,180,365,85,69,45,17,13,12,5,5,22,50,34.0%,24.0%
5507,11,209,123,332,91,56,42,23,14,17,15,2,34,49,65.3%,34.7%
5507,16,166,87,253,78,60,38,14,23,14,5,2,21,48,39.6%,29.2%
5508,19,211,150,361,99,52,25,19,23,16,10,3,29,63,41.3%,25.4%
5508,20,205,126,331,92,42,48,23,19,12,5,2,19,35,48.6%,34.3%
5509,12,220,160,380,113,53,33,17,18,17,11,0,28,58,48.3%,29.3%
5509,9,184,147,331,87,46,25,18,17,10,14,3,27,42,57.1%,23.8%
5510,10,198,155,353,47,81,68,16,15,9,10,6,25,56,33.9%,16.1%
5510,5,211,137,348,65,90,46,15,16,12,6,0,18,48,37.5%,25.0%
5511,8,219,166,385,112,57,37,23,13,24,14,1,39,63,60.3%,38.1%
5511,18,169,143,312,75,42,32,13,23,13,7,2,22,41,48.8%,31.7%
5512,2,242,152,394,127,38,32,27,15,22,15,3,40,65,56.9%,33.8%
5512,1,174,147,321,81,38,34,15,27,12,6,2,20,36,50.0%,33.3%
5513,3,181,131,312,66,65,52,23,18,11,9,1,21,46,43.5%,23.9%
5513,15,218,169,387,106,61,37,18,23,15,8,2,25,58,39.7%,25.9%
5514,14,175,172,347,89,72,34,17,18,18,6,9,33,54,44.4%,33.3%
5514,7,203,136,339,102,50,38,18,17,11,13,2,26,43,55.8%,25.6%
5515,3,172,135,307,72,43,37,33,24,8,10,2,20,48,37.5%,16.7%
5515,12,238,126,364,117,71,28,24,33,24,10,2,36,59,57.6%,40.7%
5516,20,179,130,309,67,57,43,30,26,9,3,2,14,35,34.3%,25.7%
5516,13,191,170,361,87,73,33,27,29,11,15,3,29,50,52.0%,22.0%
5517,16,231,168,399,116,65,45,17,18,13,14,2,29,55,49.1%,23.6%
5517,2,177,180,357,82,67,19,18,17,11,6,0,17,46,37.0%,23.9%
5518,9,204,163,367,87,56,21,19,21,13,12,5,30,56,44.6%,23.2%
5518,11,217,112,329,102,51,48,21,19,12,12,1,25,58,41.4%,20.7%
5519,5,199,118,317,77,60,27,20,14,8,12,1,21,43,46.5%,18.6%
5519,15,238,141,379,123,57,46,14,20,13,10,3,26,54,42.6%,24.1%
5520,18,199,140,339,105,48,19,25,24,6,11,3,20,48,35.4%,12.5%
5520,4,201,161,362,99,46,46,24,25,14,10,4,28,46,52.2%,30.4%
5521,1,187,155,342,84,40,42,16,23,13,6,1,20,44,43.2%,29.5%
5521,10,226,166,392,92,67,43,23,16,26,8,3,37,60,56.7%,43.3%
5522,8,226,228,454,98,62,51,21,13,19,12,3,34,66,47.0%,28.8%
5522,19,160,178,338,77,54,20,13,21,10,4,1,15,33,42.4%,30.3%
5523,2,229,183,412,122,43,21,23,17,13,20,4,37,71,46.5%,18.3%
5523,3,180,140,320,61,50,30,18,23,8,8,1,17,40,40.0%,20.0%
5524,7,247,147,394,125,62,30,11,15,25,11,2,38,68,52.9%,36.8%
5524,20,176,158,334,75,55,39,15,11,5,2,3,10,32,21.9%,15.6%
5525,18,196,119,315,56,61,50,28,21,14,7,2,23,49,42.9%,28.6%
5525,9,188,122,310,58,66,43,21,28,16,7,1,24,48,47.9%,33.3%
5526,10,202,171,373,60,81,53,25,12,14,6,5,25,57,35.1%,24.6%
5526,8,198,137,335,67,56,50,12,25,15,12,0,27,58,46.6%,25.9%
5527,19,191,100,291,90,44,29,19,18,15,6,2,23,43,48.8%,34.9%
5527,12,211,154,365,81,57,50,18,19,11,18,2,31,66,43.9%,16.7%
5528,4,202,160,362,77,42,59,22,17,15,14,3,32,53,54.7%,28.3%
5528,5,202,126,328,101,57,12,17,22,8,7,3,18,33,45.5%,24.2%
5529,14,222,161,383,132,69,33,24,19,16,7,4,27,57,40.4%,28.1%
5529,1,195,230,425,89,52,40,19,24,11,6,1,18,44,38.6%,25.0%
5530,15,174,154,328,73,75,15,24,25,12,6,1,19,42,42.9%,28.6%
5530,16,246,139,385,108,61,62,25,24,20,11,1,32,60,51.7%,33.3%
5531,13,188,168,356,85,53,25,24,23,11,14,1,26,51,49.0%,21.6%
5531,11,218,108,326,95,55,42,23,24,22,13,5,40,51,68.6%,43.1%
5532,3,184,129,313,82,42,24,9,17,10,8,4,22,50,36.0%,20.0%
5532,5,246,151,397,126,47,40,17,9,14,16,4,34,58,51.7%,24.1%
5533,11,232,157,389,110,55,44,18,19,22,20,1,43,57,73.7%,38.6%
5533,19,175,138,313,79,46,24,19,18,9,6,2,17,39,38.5%,23.1%
5534,12,197,149,346,86,66,48,15,18,12,15,4,31,54,50.0%,22.2%
5534,7,198,136,334,99,66,33,19,15,16,8,2,26,52,46.2%,30.8%
5535,9,209,165,374,100,48,30,22,24,19,12,2,33,63,49.2%,30.2%
5535,1,195,199,394,93,59,45,24,22,9,5,2,16,42,33.3%,21.4%
5536,8,219,147,366,86,60,19,13,19,14,11,0,25,53,47.2%,26.4%
5536,4,200,159,359,82,74,52,19,13,10,7,3,20,51,33.3%,19.6%
5537,14,228,133,361,100,89,40,22,20,17,8,2,27,71,35.2%,23.9%
5537,10,183,189,372,68,68,32,21,22,11,7,5,23,41,43.9%,26.8%
5538,2,202,149,351,97,50,32,20,18,16,9,1,26,52,48.1%,30.8%
5538,18,178,153,331,83,58,37,18,20,16,8,2,26,52,46.2%,30.8%
5539,16,244,144,388,130,52,49,26,13,14,13,4,31,60,45.0%,23.3%
5539,13,152,128,280,64,63,35,13,26,5,6,4,15,31,35.5%,16.1%
5540,20,200,175,375,70,43,39,24,20,11,8,3,22,55,34.5%,20.0%
5540,15,240,178,418,117,52,32,21,24,16,8,1,25,47,51.1%,34.0%
5541,8,202,150,352,56,72,35,17,19,20,15,0,35,64,54.7%,31.2%
5541,5,203,137,340,71,77,55,19,16,15,5,2,22,47,42.6%,31.9%
5542,11,201,133,334,79,50,42,23,17,5,10,2,17,59,25.4%,8.5%
5542,10,215,175,390,82,75,35,17,22,11,5,0,16,37,43.2%,29.7%
5543,14,182,139,321,52,86,31,23,13,11,11,3,25,54,40.7%,20.4%
5543,16,211,114,325,94,77,44,13,23,14,8,4,26,47,46.8%,29.8%
5544,4,231,127,358,112,38,62,15,21,24,13,5,42,71,52.1%,33.8%
5544,15,170,119,289,57,36,29,21,15,9,10,2,21,43,44.2%,20.9%
5545,11,222,136,358,112,65,27,16,18,12,9,0,21,44,47.7%,27.3%
5545,16,203,93,296,84,65,38,18,16,11,4,1,16,43,34.9%,25.6%
5546,5,236,118,354,98,79,27,17,16,10,9,4,23,57,33.3%,17.5%
5546,4,184,145,329,74,59,52,16,18,9,6,0,15,43,34.9%,20.9%
5547,10,215,162,377,84,67,48,13,8,13,13,5,31,53,49.1%,24.5%
5547,5,219,120,339,108,64,38,8,13,10,8,2,20,44,40.9%,22.7%
5548,8,207,150,357,88,60,33,24,21,13,16,3,32,64,45.3%,20.3%
5548,11,213,150,363,115,39,45,22,24,14,7,1,22,38,55.3%,36.8%
5549,8,194,142,336,56,84,60,21,10,11,13,2,26,61,39.3%,18.0%
5549,10,190,143,333,69,110,44,10,21,14,6,1,21,43,46.5%,32.6%
5550,11,187,123,310,63,47,44,24,26,11,11,5,27,48,45.8%,22.9%
5550,3,224,120,344,82,73,37,26,24,18,8,1,27,62,41.9%,29.0%
5551,16,206,129,335,87,74,35,20,25,16,11,1,28,61,44.3%,26.2%
5551,4,179,110,289,58,83,47,25,20,11,10,4,25,38,55.3%,28.9%
5552,12,198,149,347,67,49,34,18,20,14,14,3,31,58,48.3%,24.1%
5552,2,212,130,342,69,40,37,20,18,14,16,6,36,60,50.0%,23.3%
5553,1,245,135,380,116,71,39,25,26,19,9,4,32,55,50.9%,34.5%
5553,9,168,136,304,54,73,34,26,25,7,14,3,24,47,44.7%,14.9%
5554,20,207,139,346,81,53,36,22,25,11,9,1,21,50,40.0%,22.0%
5554,10,207,154,361,70,69,49,25,22,16,8,2,26,48,50.0%,33.3%
5555,19,202,133,335,73,54,32,15,23,13,11,1,25,50,48.0%,26.0%
5555,7,226,129,355,98,49,40,23,15,10,12,5,27,59,37.3%,16.9%
5556,13,170,126,296,73,54,41,27,23,8,4,2,14,41,29.3%,19.5%
5556,18,226,151,377,98,62,32,24,27,19,15,4,38,62,54.8%,30.6%
5557,15,209,144,353,73,39,44,23,22,13,9,0,22,53,41.5%,24.5%
5557,5,210,117,327,92,57,26,22,23,15,11,2,28,52,50.0%,28.8%
5558,8,216,189,405,82,53,32,27,17,12,13,1,26,66,37.9%,18.2%
5558,14,207,164,371,97,61,28,17,27,13,11,4,28,57,42.1%,22.8%
5559,7,205,145,350,94,55,29,15,23,12,7,3,22,52,36.5%,23.1%
5559,2,212,147,359,93,41,31,23,15,14,14,1,29,56,50.0%,25.0%
5560,10,218,151,369,45,73,57,28,33,17,8,4,29,58,43.1%,29.3%
5560,19,201,116,317,57,63,38,33,28,11,6,1,18,44,38.6%,25.0%
5561,1,204,146,350,80,61,53,27,19,11,11,1,23,47,46.8%,23.4%
5561,16,209,112,321,112,63,29,19,27,16,9,1,26,48,52.1%,33.3%
5562,9,182,128,310,66,65,51,26,25,10,14,3,27,54,44.4%,18.5%
5562,11,216,115,331,97,59,29,25,26,14,11,1,26,61,41.0%,23.0%
5563,18,225,164,389,110,55,26,28,24,19,14,6,39,67,49.3%,28.4%
5563,20,189,119,308,70,53,28,25,28,11,11,1,23,39,56.4%,28.2%
5564,3,271,181,452,144,61,40,21,19,28,13,3,44,78,52.6%,35.9%
5564,13,152,110,262,74,35,33,19,21,5,5,1,11,28,35.7%,17.9%
5565,14,173,177,350,57,72,35,29,22,16,16,0,32,71,45.1%,22.5%
5565,15,232,123,355,107,72,53,22,29,17,5,1,23,41,53.7%,41.5%
5566,5,233,126,359,88,62,21,21,13,17,10,5,32,64,42.2%,26.6%
5566,12,182,117,299,55,64,43,13,21,15,8,2,25,55,41.8%,27.3%
5567,4,173,132,305,63,52,48,23,23,15,5,3,23,37,54.1%,40.5%
5567,8,213,145,358,77,65,47,23,23,23,6,4,33,62,46.8%,37.1%
5568,16,218,100,318,66,88,44,26,18,9,14,0,23,59,39.0%,15.3%
5568,3,208,139,347,55,85,59,19,26,10,11,1,22,46,45.7%,21.7%
5569,15,220,119,339,94,59,45,23,16,13,6,8,27,49,38.8%,26.5%
5569,10,205,152,357,71,57,57,16,23,20,9,2,31,58,50.0%,34.5%
5570,13,179,145,324,72,56,46,18,20,13,5,0,18,42,42.9%,31.0%
5570,4,216,175,391,83,78,33,20,18,27,13,2,42,62,64.5%,43.5%
5571,20,177,115,292,74,41,38,27,13,10,8,0,18,42,42.9%,23.8%
5571,7,231,197,428,111,42,33,14,26,21,12,2,35,62,53.2%,33.9%
5572,19,214,123,337,56,83,42,21,14,13,12,2,27,55,45.5%,23.6%
5572,9,216,139,355,64,68,35,14,21,13,5,11,29,59,30.5%,22.0%
5573,14,209,162,371,102,55,34,19,14,18,10,1,29,58,48.3%,31.0%
5573,12,201,144,345,78,60,32,14,18,15,12,1,28,55,49.1%,27.3%
5574,2,241,159,400,127,50,25,29,34,20,13,2,35,62,53.2%,32.3%
5574,1,162,130,292,55,45,38,34,29,10,4,4,18,39,35.9%,25.6%
5575,5,207,159,366,66,74,37,13,22,13,12,0,25,51,49.0%,25.5%
5575,8,224,148,372,67,75,43,22,13,22,10,3,35,59,54.2%,37.3%
5576,18,215,154,369,84,58,46,25,24,17,11,5,33,56,50.0%,30.4%
5576,11,204,127,331,75,59,39,24,25,16,10,3,29,50,52.0%,32.0%
5577,10,196,153,349,64,50,45,23,23,16,4,3,23,59,33.9%,27.1%
5577,14,205,174,379,79,55,38,23,23,19,9,1,29,61,45.9%,31.1%
5578,8,221,166,387,116,67,48,17,21,18,9,1,28,50,54.0%,36.0%
5578,16,189,139,328,77,52,34,21,17,11,6,4,21,45,37.8%,24.4%
5579,2,187,148,335,70,33,36,17,18,11,11,2,24,47,46.8%,23.4%
5579,5,234,115,349,127,48,26,18,17,16,14,3,33,55,54.5%,29.1%
5580,7,185,139,324,77,57,33,22,28,13,11,2,26,52,46.2%,25.0%
5580,3,253,158,411,124,50,41,28,22,19,11,3,33,59,50.8%,32.2%
5581,4,198,134,332,73,68,37,22,17,7,15,8,30,51,43.1%,13.7%
5581,12,203,173,376,69,63,32,18,21,12,13,4,29,43,58.1%,27.9%
5582,19,210,145,355,81,42,26,11,20,9,9,3,21,56,32.1%,16.1%
5582,18,244,162,406,127,55,33,20,11,16,5,3,24,53,39.6%,30.2%
5583,13,210,150,360,87,85,50,26,19,22,10,2,34,58,55.2%,37.9%
5583,20,192,182,374,56,55,35,20,26,15,9,4,28,45,53.3%,33.3%
5584,11,225,158,383,69,99,50,19,15,12,3,5,20,52,28.8%,23.1%
5584,1,204,149,353,49,93,56,15,19,4,3,1,8,40,17.5%,10.0%
5585,15,235,166,401,109,41,39,25,21,18,15,2,35,64,51.6%,28.1%
5585,9,188,154,342,89,50,25,21,25,9,7,1,17,46,34.8%,19.6%
5586,3,215,138,353,99,56,50,17,14,18,12,1,31,52,57.7%,34.6%
5586,5,209,156,365,99,50,21,14,17,10,13,2,25,47,48.9%,21.3%
5587,7,197,127,324,67,98,36,11,18,9,7,2,18,50,32.0%,18.0%
5587,10,197,167,364,64,90,56,19,11,11,11,2,24,59,37.3%,18.6%
5588,16,236,132,368,111,64,39,26,21,12,8,1,21,50,40.0%,24.0%
5588,2,207,134,341,76,73,38,21,26,12,4,4,20,45,35.6%,26.7%
5589,20,200,137,337,99,53,22,8,19,16,6,2,24,47,46.8%,34.0%
5589,19,243,143,386,115,46,29,19,7,21,19,3,43,61,65.6%,34.4%
5590,12,226,172,398,72,56,37,21,12,17,10,3,30,64,42.2%,26.6%
5590,11,203,121,324,99,58,36,12,21,12,9,2,23,51,41.2%,23.5%
5591,18,202,164,366,68,67,31,18,14,12,12,0,24,50,48.0%,24.0%
5591,4,228,120,348,114,70,35,14,18,10,14,5,29,50,48.0%,20.0%
5592,1,211,151,362,99,40,42,13,14,13,8,0,21,46,45.7%,28.3%
5592,14,211,179,390,102,49,25,14,13,15,11,6,32,68,38.2%,22.1%
5593,9,219,201,420,91,50,43,17,21,17,18,2,37,63,55.6%,27.0%
5593,13,185,117,302,75,59,43,21,16,14,9,1,24,47,48.9%,29.8%
5594,8,204,126,330,99,49,26,15,29,14,14,1,29,47,59.6%,29.8%
5594,15,216,134,350,72,44,47,30,15,13,13,5,31,62,41.9%,21.0%
5595,5,229,134,363,132,59,35,24,21,15,11,2,28,48,54.2%,31.2%
5595,7,182,108,290,91,40,39,21,24,11,9,2,22,45,44.4%,24.4%
5596,3,228,160,388,106,67,30,19,24,17,16,2,35,69,47.8%,24.6%
5596,20,218,130,348,106,51,41,24,19,12,7,2,21,41,46.3%,29.3%
5597,15,200,136,336,75,66,50,38,15,14,8,1,23,54,40.7%,25.9%
5597,18,159,148,307,58,78,31,15,38,12,8,3,23,43,46.5%,27.9%
5598,11,214,136,350,114,54,35,20,23,11,9,3,23,50,40.0%,22.0%
5598,8,207,168,375,80,50,35,23,20,13,10,1,24,52,44.2%,25.0%
5599,19,191,158,349,82,74,37,18,23,7,9,3,19,45,35.6%,15.6%
5599,16,215,119,334,94,68,47,23,18,15,8,1,24,45,51.1%,33.3%
5600,2,199,153,352,95,53,35,13,17,13,7,2,22,46,43.5%,28.3%
5600,14,226,164,390,114,51,45,18,13,20,9,2,31,58,50.0%,34.5%
5601,10,203,174,377,83,70,50,18,26,17,11,2,30,51,54.9%,33.3%
5601,9,182,174,356,67,65,35,27,18,8,6,1,15,45,31.1%,17.8%
5602,12,226,152,378,107,79,60,16,26,18,8,5,31,51,51.0%,35.3%
5602,13,167,103,270,65,64,30,26,16,8,10,2,20,40,45.0%,20.0%
5603,4,236,134,370,114,80,57,24,11,21,10,1,32,52,59.6%,40.4%
5603,1,176,142,318,54,65,40,11,24,10,5,2,17,53,28.3%,18.9%
5604,14,195,165,360,105,63,30,15,16,17,9,2,28,47,55.3%,36.2%
5604,3,226,141,367,105,67,34,16,15,11,13,6,30,54,44.4%,20.4%
5605,18,160,158,318,75,54,33,21,15,10,9,4,23,44,43.2%,22.7%
5605,2,253,118,371,148,57,44,15,21,18,6,0,24,45,53.3%,40.0%
5606,9,223,151,374,100,70,41,22,20,12,6,4,22,52,34.6%,23.1%
5606,4,183,125,308,52,68,59,21,22,17,5,1,23,46,47.8%,37.0%
5607,1,159,128,287,59,80,41,26,20,15,5,2,22,45,44.4%,33.3%
5607,15,215,134,349,93,71,37,21,26,22,15,4,41,59,62.7%,37.3%
5608,16,223,147,370,104,63,29,17,18,15,9,1,25,44,54.5%,34.1%
5608,5,225,145,370,117,61,38,17,17,10,9,4,23,47,40.4%,21.3%
5609,8,233,167,400,109,64,53,11,21,18,9,2,29,53,50.9%,34.0%
5609,10,198,145,343,84,76,37,21,11,12,9,1,22,51,41.2%,23.5%
5610,20,189,131,320,104,35,39,7,19,7,8,2,17,42,35.7%,16.7%
5610,11,254,181,435,148,37,26,19,7,29,11,2,42,67,59.7%,43.3%
5611,13,178,131,309,73,39,42,19,29,7,12,0,19,43,44.2%,16.3%
5611,19,235,175,410,106,71,40,28,18,16,15,3,34,57,54.4%,28.1%
5612,7,217,171,388,116,81,29,13,12,11,11,0,22,41,53.7%,26.8%
5612,12,175,130,305,74,61,55,12,13,9,12,2,23,51,41.2%,17.6%
5613,4,194,93,287,93,65,46,21,17,12,17,1,30,50,58.0%,24.0%
5613,15,216,98,314,112,42,27,17,21,13,7,3,23,50,40.0%,26.0%
5614,3,222,176,398,97,49,42,14,11,12,12,2,26,61,39.3%,19.7%
5614,9,216,109,325,109,72,45,11,14,14,12,0,26,39,66.7%,35.9%
5615,8,213,194,407,86,56,52,24,27,21,13,1,35,60,56.7%,35.0%
5615,20,190,139,329,71,82,38,28,24,9,3,0,12,34,35.3%,26.5%
5616,19,214,120,334,109,54,18,18,19,13,15,0,28,54,51.9%,24.1%
5616,1,206,191,397,90,42,42,19,18,8,10,3,21,51,35.3%,15.7%
5617,10,204,183,387,99,90,51,19,14,11,3,1,15,47,29.8%,23.4%
5617,16,210,142,352,100,79,39,14,19,9,12,4,25,61,34.4%,14.8%
5618,5,220,158,378,103,63,34,12,22,15,10,2,27,59,42.4%,25.4%
5618,14,202,157,359,93,54,39,22,12,14,10,2,26,48,50.0%,29.2%
5619,12,208,146,354,86,77,42,22,24,16,9,4,29,54,46.3%,29.6%
5619,18,170,143,313,67,82,41,24,22,14,7,0,21,40,52.5%,35.0%
5620,2,243,132,375,133,65,36,23,21,15,13,3,31,53,52.8%,28.3%
5620,13,170,100,270,83,68,57,21,22,11,6,0,17,34,50.0%,32.4%
5621,11,246,131,377,147,47,35,13,13,12,12,3,27,49,49.0%,24.5%
5621,7,205,145,350,103,41,19,13,13,6,11,0,17,41,41.5%,14.6%
5622,5,193,169,362,79,90,33,20,9,8,4,3,15,54,22.2%,14.8%
5622,10,208,181,389,93,78,42,9,19,15,10,2,27,45,55.6%,33.3%
5623,18,198,175,373,90,55,30,14,17,9,12,2,23,47,44.7%,19.1%
5623,14,213,171,384,101,57,42,17,14,18,7,1,26,51,49.0%,35.3%
5624,20,179,159,338,81,59,22,14,22,8,4,3,15,42,28.6%,19.0%
5624,4,234,158,392,109,77,55,22,14,23,16,1,40,63,61.9%,36.5%
5625,7,184,133,317,90,72,36,27,24,15,9,2,26,39,61.5%,38.5%
5625,1,197,171,368,77,69,49,24,27,17,6,2,25,53,43.4%,32.1%
5626,9,176,118,294,86,59,28,14,15,12,11,2,25,43,53.5%,27.9%
5626,12,218,126,344,102,39,49,15,13,13,17,3,33,58,51.7%,22.4%
5627,2,211,164,375,99,49,21,18,14,9,8,0,17,40,42.5%,22.5%
5627,3,234,149,383,116,61,42,14,18,13,8,5,26,59,35.6%,22.0%
5628,8,228,220,448,100,70,59,14,15,18,7,3,28,70,35.7%,25.7%
5628,19,199,175,374,80,61,28,15,14,14,5,3,22,42,45.2%,33.3%
5629,15,201,141,342,100,67,46,17,13,19,7,3,29,51,51.0%,37.3%
5629,11,203,148,351,84,45,25,13,17,18,12,5,35,53,56.6%,34.0%
5630,16,286,185,471,167,68,33,13,13,19,12,4,35,54,57.4%,35.2%
5630,13,165,141,306,83,74,50,13,12,6,3,1,10,25,36.0%,24.0%
5631,9,180,112,292,75,61,27,17,16,7,8,1,16,43,34.9%,16.3%
5631,5,230,205,435,103,67,51,16,17,14,14,2,30,64,43.8%,21.9%
5632,12,234,161,395,103,66,50,15,15,22,12,4,38,64,53.1%,34.4%
5632,20,198,157,355,95,59,36,15,15,8,2,4,14,39,25.6%,20.5%
5633,11,224,131,355,60,78,61,26,16,8,9,2,19,52,32.7%,15.4%
5633,16,230,121,351,74,84,38,16,26,10,4,2,16,44,31.8%,22.7%
5634,10,235,153,388,49,70,59,7,13,17,12,1,30,56,51.8%,30.4%
5634,3,228,121,349,65,64,69,13,7,10,6,5,21,61,26.2%,16.4%
5635,1,206,176,382,53,90,62,19,17,10,5,2,17,44,34.1%,22.7%
5635,18,198,143,341,65,97,38,17,18,8,10,0,18,51,35.3%,15.7%
5636,14,214,161,375,92,59,31,13,7,18,11,4,33,61,47.5%,29.5%
5636,19,196,156,352,68,68,40,7,13,10,10,1,21,43,46.5%,23.3%
5637,13,189,140,329,101,75,52,13,13,6,9,3,18,40,37.5%,15.0%
5637,8,218,201,419,76,52,43,13,13,21,13,4,38,64,53.1%,32.8%
5638,15,255,160,415,136,51,58,24,11,19,16,3,38,54,64.8%,35.2%
5638,7,168,123,291,69,54,39,11,24,10,4,1,15,33,42.4%,30.3%
5639,4,196,128,324,79,84,81,16,9,8,9,5,22,48,35.4%,16.7%
5639,2,214,137,351,97,70,27,9,16,16,6,1,23,47,46.8%,34.0%
5640,3,214,147,361,103,45,37,8,9,11,10,1,22,44,47.7%,25.0%
5640,12,235,130,365,115,59,40,9,8,10,9,3,22,53,35.8%,18.9%
5641,20,199,130,329,80,82,48,14,16,15,6,2,23,46,45.7%,32.6%
5641,14,183,182,365,92,91,53,17,14,24,10,3,37,54,63.0%,44.4%
5642,11,205,205,410,77,74,33,12,13,6,13,1,20,43,44.2%,14.0%
5642,10,214,196,410,86,85,37,13,12,19,11,2,32,65,46.2%,29.2%
5643,19,213,165,378,57,101,41,12,17,9,9,3,21,66,27.3%,13.6%
5643,15,186,115,301,42,106,61,17,12,8,2,1,11,42,23.8%,19.0%
5644,7,200,121,321,87,74,23,14,22,11,13,1,25,49,49.0%,22.4%
5644,4,201,135,336,96,40,57,22,14,12,7,5,24,49,38.8%,24.5%
5645,13,177,163,340,82,43,38,12,21,5,8,1,14,35,37.1%,14.3%
5645,5,226,204,430,116,57,20,21,11,17,17,3,37,66,51.5%,25.8%
5646,12,205,129,334,81,67,44,13,22,13,7,2,22,50,40.0%,26.0%
5646,8,183,132,315,62,55,51,22,13,15,9,3,27,53,45.3%,28.3%
5647,2,220,133,353,86,72,32,22,24,16,14,0,30,59,50.8%,27.1%
5647,11,208,144,352,82,59,55,24,22,10,11,1,22,52,40.4%,19.2%
5648,16,247,142,389,135,48,42,21,16,12,12,2,26,48,50.0%,25.0%
5648,9,202,143,345,92,58,34,16,19,6,8,2,16,43,32.6%,14.0%
5649,3,252,211,463,134,44,27,13,11,17,11,2,30,59,47.5%,28.8%
5649,19,190,183,373,89,48,28,11,13,11,5,1,17,45,35.6%,24.4%
5650,20,207,172,379,91,67,38,15,12,6,11,3,20,41,41.5%,14.6%
5650,18,224,226,450,99,53,43,12,15,19,8,3,30,67,40.3%,28.4%
5651,5,210,184,394,104,74,37,10,8,15,8,1,24,53,43.4%,28.3%
5651,1,223,174,397,116,57,38,8,10,9,8,3,20,47,36.2%,19.1%
5652,8,197,137,334,68,75,32,13,20,19,9,0,28,49,57.1%,38.8%
5652,4,212,171,383,94,72,48,20,13,16,3,4,23,57,33.3%,28.1%
5653,18,225,139,364,66,98,46,22,18,10,11,1,22,52,40.4%,19.2%
5653,10,193,137,330,44,100,51,18,22,8,4,2,14,43,27.9%,18.6%
5654,7,221,179,400,99,47,28,16,22,16,5,3,24,45,46.7%,35.6%
5654,13,205,161,366,108,47,41,22,16,10,9,0,19,46,41.3%,21.7%
5655,1,192,152,344,91,61,41,18,14,8,12,1,21,46,43.5%,17.4%
5655,2,219,125,344,96,39,33,14,18,17,15,4,36,61,52.5%,27.9%
5656,16,218,145,363,91,78,39,20,21,10,5,2,17,47,31.9%,21.3%
5656,15,197,150,347,87,82,52,21,20,4,3,2,9,36,19.4%,11.1%
5657,9,196,171,367,70,56,42,17,20,15,11,2,28,54,48.1%,27.8%
5657,14,221,159,380,103,59,32,20,17,14,12,2,28,62,41.9%,22.6%
5658,4,229,154,383,98,62,38,16,11,13,8,5,26,49,42.9%,26.5%
5658,3,213,133,346,91,63,41,11,16,15,7,1,23,48,45.8%,31.2%
5659,10,232,114,346,39,95,53,16,12,8,14,3,25,55,40.0%,14.5%
5659,12,218,89,307,47,100,52,12,16,5,8,5,18,56,23.2%,8.9%
5660,19,185,191,376,69,46,20,12,12,11,14,3,28,59,42.4%,18.6%
5660,11,244,164,408,126,45,44,12,12,16,11,4,31,57,47.4%,28.1%
5661,18,235,184,419,102,70,30,18,13,13,8,0,21,54,38.9%,24.1%
5661,5,209,195,404,98,73,28,13,18,7,6,3,16,38,34.2%,18.4%
5662,13,210,135,345,94,81,38,24,16,15,8,5,28,56,41.1%,26.8%
5662,1,185,155,340,58,76,54,16,24,15,8,2,25,51,45.1%,29.4%
5663,14,224,194,418,85,80,40,18,19,11,15,4,30,59,44.1%,18.6%
5663,16,191,125,316,86,82,33,19,18,7,1,1,9,32,25.0%,21.9%
5664,8,222,125,347,75,69,40,22,12,21,15,2,38,56,64.3%,37.5%
5664,9,177,140,317,61,71,39,12,22,12,9,4,25,56,37.5%,21.4%
5665,15,224,162,386,127,50,30,20,14,19,11,5,35,49,61.2%,38.8%
5665,20,201,123,324,115,37,39,14,20,6,7,1,14,26,50.0%,23.1%
5666,2,239,128,367,104,50,48,25,14,17,11,6,34,70,40.0%,24.3%
5666,7,195,131,326,92,60,36,14,25,8,7,0,15,31,48.4%,25.8%
5667,12,191,143,334,75,60,38,17,16,12,5,0,17,38,44.7%,31.6%
5667,5,216,173,389,83,74,41,16,17,17,13,3,33,61,49.2%,27.9%
5668,20,176,122,298,76,71,43,22,18,12,8,3,23,36,55.6%,33.3%
5668,1,186,183,369,60,66,46,18,21,13,6,3,22,57,33.3%,22.8%
5669,15,227,174,401,90,62,56,15,18,19,12,2,33,53,58.5%,35.8%
5669,2,179,123,302,60,73,38,18,15,8,15,3,26,56,41.1%,14.3%
5670,9,226,123,349,106,69,32,15,21,17,12,2,31,60,48.3%,28.3%
5670,19,195,140,335,86,44,36,21,14,12,10,1,23,45,48.9%,26.7%
5671,11,218,132,350,88,51,37,22,17,9,13,2,24,54,40.7%,16.7%
5671,4,220,135,355,82,69,42,18,22,11,6,3,20,49,34.7%,22.4%
5672,14,223,125,348,104,77,36,15,20,11,11,5,27,50,44.0%,22.0%
5672,8,214,134,348,75,64,39,22,15,10,10,2,22,59,33.9%,16.9%
5673,13,215,140,355,125,61,33,13,16,13,6,1,20,36,52.8%,36.1%
5673,10,198,198,396,60,59,53,16,13,16,17,3,36,62,53.2%,25.8%
5674,16,237,202,439,126,47,38,14,14,15,8,2,25,56,41.1%,26.8%
5674,7,181,149,330,68,77,27,14,14,11,3,1,15,40,35.0%,27.5%
5675,3,258,161,419,135,69,38,17,13,18,8,2,28,54,48.1%,33.3%
5675,18,195,151,346,77,63,48,13,16,12,14,2,28,61,42.6%,19.7%
5676,5,223,184,407,93,61,28,13,17,17,8,1,26,62,40.3%,27.4%
5676,11,224,134,358,116,56,25,17,13,12,11,1,24,48,47.9%,25.0%
5677,18,169,194,363,64,59,32,23,23,12,6,1,19,46,39.1%,26.1%
5677,8,216,144,360,88,77,47,23,23,19,9,1,29,56,50.0%,33.9%
5678,14,219,115,334,55,102,72,20,12,13,13,7,33,70,37.1%,18.6%
5678,13,168,134,302,37,106,55,12,20,4,5,1,10,19,47.4%,21.1%
5679,2,224,138,362,87,71,45,17,13,6,15,2,23,48,43.8%,12.5%
5679,19,186,162,348,76,73,30,13,17,6,7,1,14,45,28.9%,13.3%
5680,9,186,109,295,79,65,43,18,22,18,5,4,27,57,40.4%,31.6%
5680,15,199,144,343,76,56,46,22,18,17,3,0,20,43,46.5%,39.5%
5681,12,217,118,335,114,43,39,16,18,16,8,6,30,50,48.0%,32.0%
5681,7,206,144,350,86,55,42,18,16,10,13,1,24,46,50.0%,21.7%
5682,10,242,176,418,110,48,38,15,16,24,21,6,51,76,59.2%,31.6%
5682,20,177,117,294,66,48,46,16,14,5,8,4,17,31,41.9%,16.1%
5683,1,214,201,415,82,60,32,18,17,14,6,0,20,60,33.3%,23.3%
5683,3,238,149,387,110,64,54,17,18,18,9,4,31,53,50.9%,34.0%
5684,4,190,115,305,83,86,42,23,22,14,8,1,23,47,46.8%,29.8%
5684,16,202,163,365,84,59,48,22,23,19,6,1,26,44,56.8%,43.2%
5685,15,217,127,344,85,63,44,18,22,16,10,2,28,54,48.1%,29.6%
5685,12,191,99,290,66,71,39,23,18,16,10,3,29,50,52.0%,32.0%
5686,8,209,136,345,97,73,44,21,23,13,14,3,30,49,55.1%,26.5%
5686,1,180,182,362,72,66,35,23,21,11,10,0,21,39,53.8%,28.2%
5687,7,203,147,350,84,64,48,17,14,13,12,2,27,49,51.0%,26.5%
5687,18,179,119,298,85,62,46,15,18,14,12,1,27,45,57.8%,31.1%
5688,19,210,157,367,91,62,38,8,15,13,7,0,20,48,41.7%,27.1%
5688,5,222,169,391,93,79,40,15,8,11,8,4,23,60,31.7%,18.3%
5689,13,191,118,309,71,56,45,26,18,11,7,2,20,50,36.0%,22.0%
5689,9,215,142,357,86,62,43,18,26,13,10,6,29,56,41.1%,23.2%
5690,20,202,153,355,77,70,49,21,24,11,9,2,22,40,50.0%,27.5%
5690,3,195,160,355,71,73,50,24,20,18,4,4,26,60,36.7%,30.0%
5691,2,243,159,402,114,68,36,22,15,12,11,1,24,45,51.1%,26.7%
5691,16,188,158,346,100,73,30,15,21,8,8,1,17,40,40.0%,20.0%
5692,11,233,183,416,90,70,30,20,19,14,9,1,24,60,38.3%,23.3%
5692,14,193,125,318,74,58,38,20,19,14,7,1,22,51,41.2%,27.5%
5693,4,204,160,364,102,82,52,19,13,11,10,3,24,39,53.8%,28.2%
5693,10,194,188,382,62,60,36,13,19,17,10,1,28,53,50.9%,32.1%
5694,3,194,146,340,92,57,36,8,11,13,8,1,22,40,52.5%,32.5%
5694,8,257,181,438,131,53,41,11,8,22,11,0,33,66,50.0%,33.3%
5695,19,181,138,319,80,64,25,12,13,11,7,4,22,40,45.0%,27.5%
5695,12,236,152,388,107,53,50,13,12,16,16,8,40,65,49.2%,24.6%
5696,13,158,132,290,89,69,33,10,12,4,4,0,8,30,26.7%,13.3%
5696,15,246,193,439,122,68,59,12,10,22,15,3,40,66,56.1%,33.3%
5697,5,223,170,393,108,63,27,17,12,15,12,4,31,52,51.9%,28.8%
5697,20,199,165,364,83,61,46,12,17,10,2,4,16,34,35.3%,29.4%
5698,16,217,174,391,110,57,39,17,18,11,7,2,20,33,54.5%,33.3%
5698,11,210,192,402,105,63,25,18,17,7,11,0,18,45,40.0%,15.6%
5699,14,216,182,398,114,57,33,13,11,21,6,5,32,63,42.9%,33.3%
5699,7,162,176,338,58,54,43,11,13,5,6,0,11,25,44.0%,20.0%
5700,18,208,173,381,77,74,31,22,10,9,14,3,26,58,39.7%,15.5%
5700,9,194,149,343,83,59,44,11,22,9,8,0,17,43,39.5%,20.9%
5701,1,225,205,430,88,63,29,20,15,16,13,2,31,56,51.8%,28.6%
5701,4,207,163,370,105,61,37,15,20,13,9,2,24,55,40.0%,23.6%
5702,10,208,175,383,72,59,39,20,15,16,11,3,30,65,41.5%,24.6%
5702,2,218,182,400,89,51,29,15,20,9,8,1,18,47,36.2%,19.1%
5703,15,214,218,432,83,52,57,11,25,15,4,2,21,46,41.3%,32.6%
5703,14,188,144,332,72,68,27,25,11,13,7,1,21,59,33.9%,22.0%
5704,20,226,162,388,112,55,31,19,21,19,9,1,29,56,50.0%,33.9%
5704,13,179,152,331,84,42,33,21,19,12,10,5,27,48,45.8%,25.0%
5705,8,197,135,332,90,81,43,18,15,9,11,1,21,48,41.7%,18.8%
5705,2,209,166,375,82,61,51,15,18,16,6,5,27,46,47.8%,34.8%
5706,4,223,122,345,108,62,60,26,14,20,9,1,30,49,59.2%,40.8%
5706,19,178,153,331,72,48,33,14,24,17,10,1,28,50,54.0%,34.0%
5707,9,222,164,386,114,52,44,7,19,16,9,3,28,53,47.2%,30.2%
5707,7,213,148,361,91,41,37,19,7,11,8,3,22,49,38.8%,22.4%
5708,12,204,138,342,94,83,39,19,11,12,8,0,20,42,47.6%,28.6%
5708,16,202,145,347,74,75,50,11,19,17,12,2,31,58,50.0%,29.3%
5709,1,196,210,406,64,96,48,14,14,15,6,3,24,60,35.0%,25.0%
5709,10,202,160,362,77,79,51,14,14,21,6,2,29,54,50.0%,38.9%
5710,11,220,134,354,90,64,52,18,13,15,13,0,28,50,56.0%,30.0%
5710,18,189,150,339,70,72,45,13,18,17,2,3,22,50,38.0%,34.0%
5711,5,255,143,398,110,81,27,18,10,20,8,5,33,63,44.4%,31.7%
5711,3,182,173,355,59,53,46,10,18,7,9,3,19,46,34.8%,15.2%
5712,7,211,170,381,95,46,24,19,15,7,11,3,21,47,38.3%,14.9%
5712,8,239,176,415,122,55,34,15,18,14,13,5,32,57,47.4%,24.6%
5713,2,251,173,424,124,62,32,24,15,14,11,2,27,55,45.5%,25.5%
5713,9,162,134,296,65,80,39,15,24,11,6,2,19,44,38.6%,25.0%
5714,14,211,153,364,117,72,28,20,17,20,7,2,29,49,55.1%,40.8%
5714,18,197,163,360,95,65,64,17,20,16,7,1,24,47,48.9%,34.0%
5715,12,202,123,325,78,69,56,23,12,13,8,3,24,49,42.9%,26.5%
5715,1,219,203,422,76,79,35,12,23,16,20,1,37,70,51.4%,22.9%
5716,19,191,145,336,81,61,34,18,25,13,12,0,25,45,55.6%,28.9%
5716,13,209,165,374,86,44,56,25,18,10,15,2,27,53,47.2%,18.9%
5717,10,175,143,318,65,66,49,21,17,10,9,2,21,38,50.0%,26.3%
5717,5,206,182,388,83,64,32,17,21,14,14,2,30,57,49.1%,24.6%
5718,3,226,171,397,109,67,40,9,18,9,9,4,22,60,30.0%,15.0%
5718,4,221,143,364,98,69,37,18,9,18,7,5,30,51,49.0%,35.3%
5719,11,212,155,367,99,59,46,21,18,11,9,4,24,57,35.1%,19.3%
5719,15,194,138,332,79,59,25,18,21,10,7,3,20,41,41.5%,24.4%
5720,16,227,167,394,102,60,52,20,17,24,12,1,37,51,70.6%,47.1%
5720,20,152,154,306,64,107,23,17,20,6,6,2,14,29,41.4%,20.7%
5721,8,204,169,373,72,72,37,16,16,18,9,2,29,52,51.9%,34.6%
5721,5,192,145,337,77,64,37,16,16,12,8,4,24,44,45.5%,27.3%
5722,2,179,153,332,59,65,47,22,23,14,8,4,26,51,43.1%,27.5%
5722,12,216,127,343,70,81,47,23,22,16,8,2,26,61,39.3%,26.2%
5723,18,218,173,391,107,54,45,19,17,16,14,3,33,60,50.0%,26.7%
5723,19,168,117,285,72,75,26,17,19,14,12,0,26,45,57.8%,31.1%
5724,3,191,164,355,88,46,28,16,15,9,14,2,25,42,54.8%,21.4%
5724,15,225,151,376,104,51,37,15,15,17,11,2,30,54,51.9%,31.5%
5725,4,187,151,338,73,76,47,20,20,6,5,0,11,36,30.6%,16.7%
5725,14,232,202,434,90,73,32,20,20,16,10,1,27,58,44.8%,27.6%
5726,9,215,195,410,94,61,34,25,21,18,12,3,33,67,44.8%,26.9%
5726,20,185,123,308,83,56,40,21,24,9,6,3,18,41,36.6%,22.0%
5727,13,187,161,348,88,54,29,19,21,5,6,2,13,39,28.2%,12.8%
5727,16,259,192,451,135,58,31,21,19,20,9,4,33,64,45.3%,31.2%
5728,10,212,177,389,85,57,52,13,13,18,9,1,28,63,42.9%,28.6%
5728,7,199,178,377,91,46,36,13,13,8,10,1,19,41,43.9%,19.5%
5729,1,190,198,388,88,64,41,21,21,20,10,1,31,47,63.8%,42.6%
5729,11,186,136,322,69,51,33,21,21,17,10,2,29,53,50.9%,32.1%
5730,5,237,217,454,116,65,28,15,15,15,10,1,26,58,43.1%,25.9%
5730,4,185,195,380,75,51,38,15,15,5,7,2,14,44,27.3%,11.4%
5731,11,218,186,404,104,64,59,25,11,18,8,4,30,54,48.1%,33.3%
5731,13,173,152,325,87,70,37,11,24,7,8,2,17,34,44.1%,20.6%
5732,15,213,174,387,94,45,28,20,12,15,7,6,28,52,42.3%,28.8%
5732,8,191,135,326,87,65,39,12,20,17,11,4,32,50,56.0%,34.0%
5733,14,226,207,433,108,95,24,24,14,13,13,1,27,62,41.9%,21.0%
5733,10,177,172,349,66,65,51,14,24,7,6,0,13,37,35.1%,18.9%
5734,16,217,171,388,88,61,42,20,22,21,7,1,29,45,62.2%,46.7%
5734,18,188,165,353,78,88,47,22,20,9,4,2,15,42,31.0%,21.4%
5735,12,207,127,334,73,50,41,20,17,9,20,2,31,48,60.4%,18.8%
5735,3,224,134,358,106,72,23,17,20,12,9,1,22,56,37.5%,21.4%
5736,7,249,170,419,127,43,45,17,12,17,10,4,31,63,42.9%,27.0%
5736,19,182,151,333,92,28,24,12,17,10,7,3,20,35,48.6%,28.6%
5737,20,173,145,318,77,47,39,21,15,6,3,3,12,39,23.1%,15.4%
5737,2,252,172,424,125,42,31,15,21,25,12,1,38,55,67.3%,45.5%
5738,9,205,137,342,85,62,35,26,23,15,8,2,25,49,46.9%,30.6%
5738,1,173,151,324,50,54,47,23,26,13,13,2,28,63,41.3%,20.6%
5739,5,182,156,338,82,39,27,12,16,17,9,3,29,50,52.0%,34.0%
5739,15,220,167,387,104,43,31,16,12,19,8,3,30,52,51.9%,36.5%
5740,14,197,181,378,76,53,46,21,20,15,18,4,37,61,54.1%,24.6%
5740,9,186,175,361,83,70,43,20,21,17,8,1,26,44,56.8%,38.6%
5741,10,185,166,351,72,81,56,24,16,16,3,1,20,57,33.3%,28.1%
5741,8,205,172,377,81,71,33,16,24,17,8,2,27,51,49.0%,33.3%
5742,1,210,194,404,99,57,52,23,16,16,10,1,27,52,50.0%,30.8%
5742,13,162,133,295,79,61,37,16,23,13,8,1,22,37,56.8%,35.1%
5743,7,268,252,520,143,48,22,13,14,16,14,2,32,61,49.2%,26.2%
5743,16,163,128,291,67,42,45,14,13,6,4,1,11,27,37.0%,22.2%
5744,3,202,139,341,122,45,18,10,15,9,8,3,20,45,37.8%,20.0%
5744,2,257,156,413,138,45,29,15,10,15,11,3,29,58,44.8%,25.9%
5745,4,176,161,337,72,57,44,23,20,5,9,4,18,35,40.0%,14.3%
5745,11,226,176,402,83,47,35,20,23,19,9,6,34,64,43.8%,29.7%
5746,19,214,177,391,100,60,30,14,12,22,13,1,36,61,57.4%,36.1%
5746,20,206,147,353,108,55,47,12,14,9,9,0,18,36,50.0%,25.0%
5747,18,205,160,365,109,55,36,13,17,15,9,4,28,47,51.1%,31.9%
5747,12,189,87,276,67,58,47,18,13,15,11,3,29,51,51.0%,29.4%
5748,8,237,170,407,114,60,35,19,14,15,10,5,30,54,46.3%,27.8%
5748,10,156,159,315,43,65,49,14,19,7,8,1,16,38,39.5%,18.4%
5749,14,194,168,362,82,66,16,25,19,9,11,7,27,55,36.4%,16.4%
5749,16,199,132,331,79,68,53,19,25,12,10,5,27,51,43.1%,23.5%
5750,5,194,122,316,81,81,26,19,18,9,7,2,18,58,27.6%,15.5%
5750,18,218,134,352,116,56,37,18,19,12,11,4,27,43,53.5%,27.9%
5751,2,201,119,320,88,59,37,18,19,14,8,4,26,51,43.1%,27.5%
5751,12,193,99,292,66,67,52,19,18,18,6,2,26,45,53.3%,40.0%
5752,14,197,171,368,87,68,32,22,14,13,13,5,31,65,40.0%,20.0%
5752,18,185,156,341,85,60,35,14,22,12,7,1,20,39,48.7%,30.8%
5753,10,238,204,442,93,60,33,9,14,13,6,2,21,62,30.6%,21.0%
5753,12,231,114,345,79,39,41,15,8,8,11,3,22,56,33.9%,14.3%
5754,8,239,144,383,102,62,43,19,19,14,13,5,32,64,42.2%,21.9%
5754,14,173,119,292,71,55,25,19,19,15,4,3,22,42,45.2%,35.7%
5755,16,220,168,388,95,71,53,13,25,14,11,4,29,42,59.5%,33.3%
5755,10,181,171,352,72,76,30,25,13,11,7,1,19,39,46.2%,28.2%
5756,8,221,116,337,103,80,27,15,14,11,10,1,22,45,46.7%,24.4%
5756,16,181,152,333,70,65,55,14,15,8,11,3,22,44,43.2%,18.2%
5757,5,200,157,357,76,83,25,13,14,5,9,7,21,47,29.8%,10.6%
5757,16,211,153,364,82,71,46,14,13,17,12,2,31,65,44.6%,26.2%
5758,20,219,129,348,67,88,58,25,24,15,7,2,24,51,43.1%,29.4%
5758,10,196,124,320,69,76,37,24,25,9,8,5,22,51,33.3%,17.6%
5759,19,205,169,374,80,58,31,20,22,12,13,2,27,48,52.1%,25.0%
5759,2,218,188,406,87,64,42,22,20,10,8,1,19,58,31.0%,17.2%
5760,12,170,140,310,62,57,45,20,14,12,11,4,27,43,53.5%,27.9%
5760,18,221,141,362,108,73,34,14,20,18,10,2,30,47,59.6%,38.3%
5761,14,214,150,364,91,82,42,16,12,18,9,2,29,62,43.5%,29.0%
5761,11,178,192,370,70,60,31,12,16,12,7,2,21,47,40.4%,25.5%
5762,15,159,132,291,73,63,44,9,11,9,3,3,15,40,30.0%,22.5%
5762,3,286,164,450,159,57,38,12,9,15,8,1,24,60,38.3%,25.0%
5763,8,231,167,398,104,55,46,18,12,21,10,3,34,53,58.5%,39.6%
5763,9,184,128,312,74,65,41,12,18,13,10,3,26,50,46.0%,26.0%
5764,7,227,121,348,118,54,34,16,10,10,6,2,18,38,42.1%,26.3%
5764,13,215,193,408,109,56,47,10,16,6,11,4,21,47,36.2%,12.8%
5765,4,208,180,388,90,70,53,15,16,21,7,1,29,59,47.5%,35.6%
5765,1,191,204,395,76,65,31,15,15,11,3,0,14,37,37.8%,29.7%
5766,2,220,130,350,94,55,35,13,20,14,10,4,28,52,46.2%,26.9%
5766,12,213,116,329,81,69,37,20,13,12,11,3,26,59,39.0%,20.3%
5767,3,249,162,411,130,66,40,16,11,12,9,5,26,51,41.2%,23.5%
5767,8,205,109,314,83,46,51,11,16,13,11,1,25,49,49.0%,26.5%
5768,7,226,141,367,115,74,30,15,16,15,4,1,20,50,38.0%,30.0%
5768,20,197,157,354,76,69,56,16,15,13,8,2,23,52,40.4%,25.0%
5769,18,230,139,369,90,70,32,17,24,19,11,2,32,52,57.7%,36.5%
5769,11,207,155,362,94,67,38,24,17,11,5,2,18,56,28.6%,19.6%
5770,16,215,142,357,63,75,69,18,25,12,13,2,27,61,41.0%,19.7%
5770,19,183,129,312,45,92,19,25,18,5,8,1,14,45,28.9%,11.1%
5771,10,207,164,371,81,74,43,18,15,10,9,0,19,50,38.0%,20.0%
5771,5,209,143,352,88,65,37,15,18,12,10,7,29,50,44.0%,24.0%
5772,9,195,133,328,78,81,38,24,12,10,6,2,18,44,36.4%,22.7%
5772,14,187,139,326,70,91,55,13,24,13,12,3,28,53,47.2%,24.5%
5773,13,222,169,391,123,62,31,20,17,4,5,1,10,39,23.1%,10.3%
5773,4,216,170,386,94,56,46,17,20,18,9,6,33,53,50.9%,34.0%
5774,1,186,160,346,83,61,45,13,11,8,6,0,14,42,33.3%,19.0%
5774,15,213,151,364,97,65,42,11,13,12,11,0,23,44,52.3%,27.3%
5775,8,286,206,492,130,38,32,15,10,21,7,4,32,54,51.9%,38.9%
5775,16,187,124,311,66,49,47,10,15,11,9,4,24,49,40.8%,22.4%
5776,1,180,133,313,78,83,57,21,21,15,9,1,25,44,54.5%,34.1%
5776,2,180,126,306,85,78,52,21,21,15,6,2,23,47,44.7%,31.9%
5777,11,212,162,374,96,61,41,13,15,9,14,3,26,53,43.4%,17.0%
5777,10,192,155,347,77,63,45,15,13,21,5,3,29,45,57.8%,46.7%
5778,19,212,175,387,67,66,44,17,17,17,7,5,29,58,41.4%,29.3%
5778,9,201,157,358,92,66,54,17,17,9,7,0,16,41,39.0%,22.0%
5779,4,195,133,328,91,66,60,19,17,12,11,0,23,43,53.5%,27.9%
5779,7,179,167,346,71,76,29,17,19,8,10,0,18,38,47.4%,21.1%
5780,5,220,122,342,101,55,31,14,15,11,6,4,21,42,40.5%,26.2%
5780,14,206,165,371,93,65,34,15,14,12,13,2,27,56,44.6%,21.4%
5781,20,215,136,351,58,115,79,20,23,10,12,7,29,59,37.3%,16.9%
5781,13,181,133,314,49,70,37,23,20,7,3,2,12,39,25.6%,17.9%
5782,15,228,191,419,108,83,42,17,15,14,12,1,27,51,51.0%,27.5%
5782,18,196,167,363,76,71,40,15,17,13,11,1,25,57,42.1%,22.8%
5783,3,268,178,446,150,51,28,14,15,21,8,4,33,55,52.7%,38.2%
5783,12,180,137,317,77,57,58,15,14,8,7,2,17,29,51.7%,27.6%
5784,2,192,141,333,63,76,40,21,14,10,7,5,22,47,36.2%,21.3%
5784,5,198,138,336,73,80,36,14,21,16,12,2,30,54,51.9%,29.6%
5785,12,221,153,374,99,65,41,18,23,7,13,3,23,47,42.6%,14.9%
5785,13,201,122,323,87,84,34,24,18,12,7,2,21,45,42.2%,26.7%
5786,18,243,204,447,127,74,45,21,20,24,12,3,39,63,57.1%,38.1%
5786,9,171,162,333,82,73,31,20,21,7,4,0,11,28,39.3%,25.0%
5787,20,190,145,335,67,67,42,19,14,12,8,3,23,58,34.5%,20.7%
5787,1,234,170,404,115,54,34,14,19,17,8,0,25,50,50.0%,34.0%
5788,19,190,150,340,62,61,34,15,19,7,5,2,14,53,22.6%,13.2%
5788,8,270,195,465,104,52,44,19,15,23,7,3,33,69,43.5%,33.3%
5789,14,262,165,427,137,73,25,20,11,16,11,0,27,62,43.5%,25.8%
5789,4,176,138,314,58,47,33,11,20,4,7,1,12,32,34.4%,12.5%
5790,10,214,136,350,63,77,44,17,18,6,7,5,18,66,19.7%,9.1%
5790,15,238,151,389,74,87,47,18,17,13,8,5,26,48,43.8%,27.1%
5791,7,185,152,337,79,57,30,9,9,7,7,1,15,48,29.2%,14.6%
5791,11,242,179,421,127,67,43,9,9,20,10,6,36,53,56.6%,37.7%
5792,16,237,155,392,104,57,63,18,6,18,5,0,23,45,51.1%,40.0%
5792,3,207,183,390,108,61,14,6,18,9,4,2,15,30,43.3%,30.0%
5793,9,174,170,344,68,48,38,16,20,9,8,1,18,39,43.6%,23.1%
5793,2,228,144,372,106,85,66,20,16,15,11,5,31,57,45.6%,26.3%
5794,5,248,163,411,128,64,20,11,8,13,14,1,28,58,46.6%,22.4%
5794,15,192,187,379,86,51,29,8,11,8,5,5,18,40,32.5%,20.0%
5795,10,204,194,398,81,102,19,16,20,13,13,1,27,45,57.8%,28.9%
5795,16,204,147,351,84,66,65,20,16,11,4,5,20,48,31.2%,22.9%
5796,4,198,182,380,73,77,37,19,14,7,12,2,21,41,46.3%,17.1%
5796,18,227,141,368,104,75,33,14,19,10,8,2,20,63,28.6%,15.9%
5797,3,233,177,410,136,46,29,13,13,9,9,2,20,44,40.9%,20.5%
5797,7,236,169,405,123,52,38,13,13,11,8,7,26,42,45.2%,26.2%
5798,11,244,185,429,134,41,27,19,8,21,10,1,32,54,57.4%,38.9%
5798,20,176,154,330,80,49,34,8,19,10,8,4,22,47,38.3%,21.3%
5799,13,193,124,317,75,43,41,17,18,11,10,2,23,44,47.7%,25.0%
5799,19,207,131,338,97,62,36,18,17,11,16,4,31,47,57.4%,23.4%
5800,1,164,187,351,53,74,51,17,22,13,11,2,26,55,43.6%,23.6%
5800,12,200,146,346,73,88,45,23,17,18,10,1,29,50,56.0%,36.0%
5801,14,192,137,329,87,61,37,19,17,15,11,5,31,52,50.0%,28.8%
5801,8,195,161,356,79,59,30,17,19,12,10,5,27,49,44.9%,24.5%
5802,5,207,147,354,81,98,41,22,18,12,11,0,23,45,51.1%,26.7%
5802,3,197,184,381,84,81,47,18,22,8,9,3,20,56,30.4%,14.3%
5803,7,217,172,389,93,71,53,21,22,11,12,1,24,60,38.3%,18.3%
5803,9,186,152,338,59,80,50,22,21,12,6,4,22,57,31.6%,21.1%
5804,16,213,147,360,91,60,48,21,24,8,9,4,21,55,30.9%,14.5%
5804,15,211,170,381,83,63,33,24,20,10,11,3,24,45,46.7%,22.2%
5805,19,222,161,383,90,69,27,10,19,20,12,2,34,72,44.4%,27.8%
5805,20,191,173,364,83,58,51,19,10,13,12,4,29,55,45.5%,23.6%
5806,12,225,159,384,105,72,27,17,14,14,7,1,22,53,39.6%,26.4%
5806,4,202,161,363,79,46,55,14,17,12,15,2,29,59,45.8%,20.3%
5807,13,202,164,366,101,71,48,18,13,5,8,0,13,37,35.1%,13.5%
5807,10,227,175,402,99,65,26,13,18,9,12,3,24,57,36.8%,15.8%
5808,1,194,181,375,79,61,41,19,15,12,10,1,23,47,46.8%,25.5%
5808,11,194,155,349,85,69,27,15,19,13,11,3,27,49,49.0%,26.5%
5809,2,207,157,364,108,64,43,8,13,7,8,2,17,45,33.3%,15.6%
5809,8,230,189,419,112,65,45,13,8,18,7,3,28,53,47.2%,34.0%
5810,18,217,173,390,100,52,48,16,13,16,10,1,27,49,53.1%,32.7%
5810,14,190,139,329,89,72,31,13,16,9,11,2,22,49,40.8%,18.4%
5811,12,196,129,325,88,49,30,18,14,10,7,3,20,40,42.5%,25.0%
5811,5,207,134,341,80,65,35,14,18,14,14,6,34,54,51.9%,25.9%
5812,8,261,217,478,113,56,50,10,12,27,12,1,40,68,57.4%,39.7%
5812,7,172,156,328,62,73,40,12,10,4,2,4,10,25,24.0%,16.0%
5813,20,215,158,373,105,70,49,9,19,15,6,1,22,39,53.8%,38.5%
5813,18,207,164,371,69,69,38,19,9,20,10,2,32,71,42.3%,28.2%
5814,11,196,144,340,73,72,45,21,15,9,11,2,22,64,31.2%,14.1%
5814,13,202,175,377,72,67,53,15,21,11,3,1,15,41,34.1%,26.8%
5815,9,179,141,320,95,49,38,14,17,6,7,1,14,38,34.2%,15.8%
5815,10,235,193,428,112,59,36,17,14,18,13,2,33,62,50.0%,29.0%
5816,3,225,110,335,115,59,33,20,19,10,9,4,23,46,41.3%,21.7%
5816,1,194,184,378,88,49,48,19,20,9,8,3,20,50,34.0%,18.0%
5817,15,230,155,385,106,63,51,16,17,11,6,5,22,51,33.3%,21.6%
5817,19,214,176,390,77,72,21,17,16,18,8,4,30,59,44.1%,30.5%
5818,14,218,123,341,81,79,54,13,19,11,10,5,26,58,36.2%,19.0%
5818,2,215,170,385,80,59,46,19,13,12,3,1,16,45,33.3%,26.7%
5819,4,168,139,307,80,80,27,15,16,7,12,0,19,37,51.4%,18.9%
5819,16,236,182,418,133,67,43,17,15,11,6,1,18,44,38.6%,25.0%
5820,10,202,191,393,74,85,36,14,13,15,14,3,32,65,44.6%,23.1%
5820,8,195,176,371,73,54,59,14,14,13,8,2,23,48,43.8%,27.1%
5821,18,199,177,376,78,75,35,17,11,13,12,4,29,54,46.3%,24.1%
5821,16,204,175,379,92,73,51,11,17,11,9,1,21,37,54.1%,29.7%
5822,9,195,186,381,78,53,44,19,17,8,7,2,17,43,34.9%,18.6%
5822,3,226,182,408,120,74,40,17,19,9,6,5,20,41,36.6%,22.0%
5823,13,183,126,309,66,75,70,24,13,12,8,3,23,55,36.4%,21.8%
5823,1,184,142,326,45,108,42,13,24,15,5,4,24,42,47.6%,35.7%
5824,4,233,161,394,123,64,51,19,10,30,5,3,38,67,52.2%,44.8%
5824,20,168,190,358,80,49,29,10,18,12,4,1,17,27,59.3%,44.4%
5825,7,179,145,324,67,67,30,12,15,9,12,3,24,46,45.7%,19.6%
5825,12,233,147,380,118,67,48,16,12,15,9,2,26,59,40.7%,25.4%
5826,11,231,158,389,92,93,38,15,9,10,13,3,26,60,38.3%,16.7%
5826,5,184,160,344,71,71,52,9,15,7,10,3,20,50,34.0%,14.0%
5827,3,231,196,427,100,74,49,17,15,9,8,2,19,48,35.4%,18.8%
5827,10,214,178,392,105,67,32,15,17,18,5,1,24,51,45.1%,35.3%
5828,2,183,163,346,80,81,36,12,12,9,17,3,29,50,52.0%,18.0%
5828,13,215,146,361,103,67,50,12,12,14,6,1,21,41,48.8%,34.1%
5829,15,225,192,417,104,53,45,23,14,17,20,3,40,61,60.7%,27.9%
5829,9,186,111,297,105,62,31,14,23,6,1,1,8,37,18.9%,16.2%
5830,16,210,186,396,79,58,48,13,16,13,15,3,31,56,50.0%,23.2%
5830,14,202,181,383,105,78,33,19,13,9,5,5,19,41,34.1%,22.0%
5831,7,225,150,375,87,60,50,20,18,13,8,1,22,51,41.2%,25.5%
5831,19,188,187,375,72,49,35,18,20,19,8,3,30,55,49.1%,34.5%
5832,14,213,178,391,93,77,28,22,22,16,13,2,31,49,59.2%,32.7%
5832,15,208,154,362,79,58,36,22,22,13,12,1,26,49,51.0%,26.5%
5833,20,176,143,319,89,69,34,17,19,5,9,2,16,43,32.6%,11.6%
5833,2,217,194,411,109,51,44,19,17,24,10,0,34,54,63.0%,44.4%
5834,5,202,143,345,73,92,21,13,19,17,6,1,24,51,45.1%,33.3%
5834,4,236,154,390,111,71,48,19,13,15,10,1,26,65,38.5%,23.1%
5835,18,195,156,351,84,62,47,12,19,15,8,2,25,47,48.9%,31.9%
5835,8,220,198,418,85,74,39,19,12,13,7,1,21,55,36.4%,23.6%
5836,19,201,162,363,85,66,32,19,21,18,9,2,29,54,50.0%,33.3%
5836,1,184,164,348,70,76,47,21,19,10,11,3,24,42,50.0%,23.8%
5837,12,225,149,374,94,60,36,18,14,12,9,0,21,50,42.0%,24.0%
5837,11,195,173,368,73,59,41,14,18,10,15,1,26,54,46.3%,18.5%
5838,10,252,215,467,101,68,24,10,11,22,14,2,38,75,48.0%,29.3%
5838,14,175,184,359,66,55,50,11,10,5,5,3,13,44,22.7%,11.4%
5839,7,191,148,339,97,61,43,17,18,8,6,0,14,41,34.1%,19.5%
5839,5,223,171,394,98,77,36,18,17,21,12,2,35,63,52.4%,33.3%
5840,13,229,192,421,106,41,38,16,14,11,8,1,20,43,44.2%,25.6%
5840,18,204,160,364,102,55,35,14,16,14,7,4,25,60,35.0%,23.3%
5841,9,194,142,336,77,60,16,17,24,14,10,4,28,48,50.0%,29.2%
5841,12,208,138,346,75,64,70,24,17,13,9,4,26,60,36.7%,21.7%
5842,3,253,169,422,132,68,25,19,19,15,11,3,29,67,38.8%,22.4%
5842,2,188,175,363,84,51,32,19,19,7,6,6,19,40,32.5%,17.5%
5843,11,235,138,373,82,65,41,19,14,16,11,2,29,57,47.4%,28.1%
5843,19,193,159,352,61,77,44,14,19,11,7,4,22,60,30.0%,18.3%
5844,1,203,211,414,76,74,29,19,4,6,11,4,21,67,25.4%,9.0%
5844,16,190,172,362,88,74,55,4,19,13,11,0,24,41,58.5%,31.7%
5845,8,224,153,377,73,82,55,23,17,14,7,3,24,60,35.0%,23.3%
5845,20,214,133,347,70,103,56,17,23,13,6,3,22,45,42.2%,28.9%
5846,4,216,139,355,111,93,45,15,13,6,7,1,14,52,25.0%,11.5%
5846,15,221,178,399,87,80,34,13,15,12,10,0,22,44,50.0%,27.3%
5847,14,184,157,341,68,65,40,11,8,16,9,2,27,53,47.2%,30.2%
5847,12,205,128,333,84,66,46,8,11,15,11,1,27,51,51.0%,29.4%
5848,8,206,173,379,81,77,50,19,16,19,9,0,28,62,45.2%,30.6%
5848,4,189,149,338,82,80,57,16,19,12,3,4,19,47,31.9%,25.5%
5849,18,251,170,421,135,69,55,21,13,19,13,2,34,62,51.6%,30.6%
5849,7,159,156,315,48,67,26,13,20,9,4,1,14,34,38.2%,26.5%
5850,1,166,176,342,70,97,37,18,15,13,8,1,22,49,42.9%,26.5%
5850,9,192,157,349,78,70,46,15,18,14,7,4,25,53,39.6%,26.4%
5851,20,234,137,371,104,62,40,18,15,9,8,4,21,57,29.8%,15.8%
5851,3,201,164,365,79,62,40,15,18,11,11,4,26,54,40.7%,20.4%
5852,19,207,148,355,93,61,53,18,10,10,12,2,24,48,45.8%,20.8%
5852,10,208,176,384,86,51,31,10,18,17,7,0,24,53,45.3%,32.1%
5853,16,230,213,443,115,59,44,12,11,12,16,2,30,50,56.0%,24.0%
5853,11,159,138,297,62,53,20,11,12,7,6,2,15,51,25.5%,13.7%
5854,15,191,166,357,71,76,45,29,22,17,11,3,31,49,57.1%,34.7%
5854,2,191,164,355,93,64,35,22,28,13,7,3,23,49,40.8%,26.5%
5855,13,224,141,365,132,48,20,5,13,3,6,4,13,35,25.7%,8.6%
5855,5,224,132,356,122,58,28,13,5,8,10,3,21,49,36.7%,16.3%
5856,12,203,156,359,85,58,35,22,18,13,11,1,25,45,53.3%,28.9%
5856,8,211,151,362,93,52,42,18,22,18,8,2,28,59,44.1%,30.5%
5857,2,205,202,407,95,61,30,20,13,12,9,4,25,51,41.2%,23.5%
5857,16,165,147,312,67,51,58,13,19,16,6,3,25,37,59.5%,43.2%
5858,10,196,173,369,66,81,29,17,14,14,10,4,28,55,43.6%,25.5%
5858,18,204,220,424,77,81,52,14,17,13,12,4,29,62,40.3%,21.0%
5859,4,225,130,355,115,63,53,12,11,15,6,7,28,46,45.7%,32.6%
5859,19,184,162,346,70,64,34,11,11,15,9,1,25,48,50.0%,31.2%
5860,9,189,123,312,87,47,38,21,18,12,6,2,20,41,43.9%,29.3%
5860,20,233,159,392,104,73,43,18,21,19,11,0,30,61,49.2%,31.1%
5861,11,217,146,363,101,50,36,17,20,16,8,5,29,59,40.7%,27.1%
5861,15,193,178,371,77,56,46,20,17,10,10,3,23,50,40.0%,20.0%
5862,14,228,151,379,134,72,63,24,17,20,10,3,33,57,52.6%,35.1%
5862,7,142,161,303,69,66,21,17,24,5,4,3,12,33,27.3%,15.2%
5863,5,193,157,350,84,99,42,20,11,15,4,4,23,45,42.2%,33.3%
5863,1,192,202,394,54,88,46,11,19,16,9,1,26,57,43.9%,28.1%
5864,3,222,147,369,95,83,37,15,14,10,13,4,27,69,33.3%,14.5%
5864,13,208,144,352,111,74,48,14,15,12,6,0,18,36,50.0%,33.3%
5865,2,212,188,400,94,61,36,17,16,7,7,2,16,37,37.8%,18.9%
5865,10,169,161,330,62,99,38,16,17,9,5,3,17,46,30.4%,19.6%
5866,18,217,209,426,100,89,49,14,16,19,11,3,33,65,46.2%,29.2%
5866,1,170,188,358,61,70,30,16,14,8,7,1,16,40,37.5%,20.0%
5867,8,232,163,395,124,52,33,18,15,17,9,4,30,59,44.1%,28.8%
5867,5,187,178,365,81,58,37,15,18,13,7,1,21,44,45.5%,29.5%
5868,19,222,136,358,101,66,29,14,16,17,14,2,33,60,51.7%,28.3%
5868,14,179,176,355,72,53,42,17,14,11,8,4,23,43,44.2%,25.6%
5869,16,212,171,383,66,91,66,25,17,15,11,4,30,72,36.1%,20.8%
5869,9,164,153,317,52,103,31,17,25,3,2,2,7,17,29.4%,17.6%
5870,3,225,151,376,107,58,33,11,14,15,4,7,26,57,33.3%,26.3%
5870,11,210,167,377,94,54,41,14,11,14,8,0,22,51,43.1%,27.5%
5871,20,210,144,354,90,77,58,8,22,15,8,2,25,58,39.7%,25.9%
5871,12,202,139,341,76,58,42,22,8,14,8,0,22,50,44.0%,28.0%
5872,7,199,149,348,103,66,27,9,18,10,9,1,20,44,43.2%,22.7%
5872,4,198,168,366,80,53,43,18,9,15,10,3,28,52,48.1%,28.8%
5873,13,189,169,358,89,58,50,15,13,10,5,1,16,40,37.5%,25.0%
5873,15,232,157,389,126,66,35,13,15,15,14,3,32,52,55.8%,28.8%
5874,14,214,143,357,106,68,36,14,17,13,9,2,24,53,41.5%,24.5%
5874,3,197,138,335,91,69,39,17,14,11,11,3,25,48,45.8%,22.9%
5875,8,252,127,379,59,81,64,15,12,17,8,6,31,73,34.2%,23.3%
5875,19,215,116,331,50,76,32,12,15,10,2,1,13,38,31.6%,26.3%
5876,7,188,138,326,99,77,35,17,12,11,5,2,18,45,35.6%,24.4%
5876,2,210,201,411,109,49,38,12,17,18,9,0,27,51,52.9%,35.3%
5877,16,226,160,386,108,68,53,9,14,13,10,0,23,45,51.1%,28.9%
5877,4,213,131,344,101,60,30,14,9,11,11,4,26,47,46.8%,23.4%
5878,10,222,175,397,81,62,26,22,16,15,15,1,31,56,53.6%,26.8%
5878,20,186,172,358,74,75,40,17,22,8,10,2,20,42,42.9%,19.0%
5879,9,223,143,366,112,89,42,17,15,10,5,5,20,48,31.2%,20.8%
5879,15,179,149,328,39,71,55,15,17,9,12,0,21,52,40.4%,17.3%
5880,1,183,139,322,57,86,38,21,19,14,6,1,21,45,44.4%,31.1%
5880,13,178,149,327,87,91,69,19,21,13,6,1,20,49,38.8%,26.5%
5881,11,220,145,365,68,66,43,24,11,14,10,5,29,59,40.7%,23.7%
5881,18,192,147,339,74,91,49,11,24,10,11,5,26,56,37.5%,17.9%
5882,5,209,185,394,82,91,34,7,11,13,12,1,26,56,44.6%,23.2%
5882,12,201,136,337,77,60,44,11,7,11,7,3,21,45,40.0%,24.4%
5883,15,232,207,439,111,63,39,19,18,16,9,3,28,50,50.0%,32.0%
5883,8,179,155,334,63,66,40,18,19,13,8,2,23,50,42.0%,26.0%
5884,2,211,227,438,89,50,43,17,20,12,7,0,19,52,36.5%,23.1%
5884,9,190,186,376,87,51,39,20,17,7,7,5,19,48,29.2%,14.6%
5885,20,182,153,335,75,56,38,25,12,9,16,2,27,46,54.3%,19.6%
5885,11,212,172,384,104,47,34,12,25,20,15,5,40,66,53.0%,30.3%
5886,19,212,166,378,99,52,23,13,19,11,11,3,25,43,51.2%,25.6%
5886,5,194,138,332,85,49,44,19,13,10,11,4,25,52,40.4%,19.2%
5887,13,182,133,315,71,68,42,20,19,4,9,1,14,32,40.6%,12.5%
5887,16,228,164,392,95,73,47,19,20,15,7,0,22,60,36.7%,25.0%
5888,18,202,172,374,68,62,44,17,16,7,11,7,25,54,33.3%,13.0%
5888,3,212,110,322,78,96,33,16,17,8,11,3,22,50,38.0%,16.0%
5889,12,237,133,370,139,50,43,17,15,24,4,3,31,58,48.3%,41.4%
5889,7,159,149,308,65,52,33,15,17,10,6,0,16,41,39.0%,24.4%
5890,4,214,131,345,54,96,69,15,10,7,7,2,16,51,27.5%,13.7%
5890,10,222,155,377,54,102,30,10,15,10,12,7,29,67,32.8%,14.9%
5891,14,208,138,346,85,129,53,13,25,10,8,1,19,43,41.9%,23.3%
5891,1,198,137,335,25,96,36,25,13,7,9,5,21,47,34.0%,14.9%
5892,11,190,221,411,58,72,50,14,13,14,7,1,22,52,40.4%,26.9%
5892,8,215,182,397,82,83,46,13,14,15,10,4,29,62,40.3%,24.2%
5893,13,165,130,295,61,79,36,21,21,5,3,3,11,30,26.7%,16.7%
5893,14,229,145,374,114,88,43,21,21,14,12,6,32,57,45.6%,24.6%
5894,15,226,162,388,103,60,45,16,13,13,11,3,27,48,50.0%,27.1%
5894,7,183,137,320,87,81,31,13,16,3,13,2,18,40,40.0%,7.5%
5895,1,231,189,420,78,57,43,16,8,13,11,5,29,58,41.4%,22.4%
5895,19,175,130,305,61,63,42,8,16,9,10,2,21,38,50.0%,23.7%
5896,9,177,169,346,91,67,33,22,15,9,6,4,19,52,28.8%,17.3%
5896,4,197,137,334,83,65,51,15,22,11,9,1,21,45,44.4%,24.4%
5897,10,220,155,375,92,76,59,19,12,18,12,2,32,63,47.6%,28.6%
5897,12,201,111,312,85,63,49,12,19,7,6,3,16,33,39.4%,21.2%
5898,2,209,135,344,66,78,49,17,16,19,11,1,31,60,50.0%,31.7%
5898,18,177,178,355,86,70,41,16,17,16,8,2,26,50,48.0%,32.0%
5899,3,260,165,425,148,68,34,20,17,16,6,1,23,51,43.1%,31.4%
5899,5,185,153,338,76,50,41,17,20,5,5,4,14,49,20.4%,10.2%
5900,16,217,153,370,104,52,55,17,18,21,9,1,31,57,52.6%,36.8%
5900,20,186,183,369,92,65,30,18,17,9,6,0,15,29,51.7%,31.0%
5901,12,229,107,336,127,64,33,22,14,16,9,4,29,46,54.3%,34.8%
5901,15,174,130,304,83,61,49,14,22,13,7,1,21,53,37.7%,24.5%
5902,7,270,133,403,147,72,52,14,11,17,14,2,33,59,52.5%,28.8%
5902,16,170,112,282,75,77,39,11,14,9,2,4,15,42,26.2%,21.4%
5903,20,205,162,367,98,48,33,15,15,12,12,3,27,53,45.3%,22.6%
5903,14,208,209,417,97,48,44,15,15,13,15,1,29,55,50.9%,23.6%
5904,18,203,122,325,85,89,51,24,20,10,8,4,22,48,37.5%,20.8%
5904,13,179,165,344,78,58,58,20,24,10,9,0,19,44,43.2%,22.7%
5905,1,184,152,336,70,56,40,17,18,14,5,5,24,45,42.2%,31.1%
5905,3,203,121,324,94,73,42,18,17,15,9,2,26,56,42.9%,26.8%
5906,4,197,119,316,36,126,79,30,24,6,3,3,12,44,20.5%,13.6%
5906,2,209,118,327,27,99,39,24,30,8,5,6,19,49,26.5%,16.3%
5907,9,232,167,399,80,83,46,24,16,16,10,4,30,70,37.1%,22.9%
5907,19,161,111,272,33,103,40,16,24,8,6,2,16,40,35.0%,20.0%
5908,8,210,179,389,85,47,46,16,21,15,11,3,29,55,47.3%,27.3%
5908,10,204,141,345,90,65,32,21,16,13,10,6,29,49,46.9%,26.5%
5909,5,195,145,340,70,66,33,18,19,12,8,2,22,48,41.7%,25.0%
5909,11,190,162,352,72,57,50,20,18,14,12,2,28,47,55.3%,29.8%
5910,16,190,121,311,94,63,75,14,22,12,9,2,23,47,44.7%,25.5%
5910,12,224,91,315,100,59,23,22,14,11,11,1,23,40,55.0%,27.5%
5911,10,226,178,404,98,67,54,24,11,11,9,4,24,56,35.7%,19.6%
5911,3,177,169,346,55,69,45,11,24,8,7,2,17,54,27.8%,14.8%
5912,11,187,187,374,64,67,45,13,17,16,8,1,25,53,45.3%,30.2%
5912,4,201,176,377,76,73,44,17,13,20,14,2,36,58,58.6%,34.5%
5913,2,221,137,358,111,31,30,22,17,13,8,3,24,57,36.8%,22.8%
5913,20,197,161,358,107,54,28,17,22,8,10,4,22,44,40.9%,18.2%
5914,19,182,153,335,72,50,25,22,18,17,12,3,32,49,59.2%,34.7%
5914,7,194,129,323,95,62,49,18,22,9,9,1,19,47,38.3%,19.1%
5915,15,192,145,337,94,57,41,24,19,10,13,6,29,54,42.6%,18.5%
5915,14,215,139,354,105,62,31,19,24,16,12,3,31,52,53.8%,30.8%
5916,13,197,165,362,92,47,38,21,15,6,13,2,21,34,55.9%,17.6%
5916,9,216,140,356,123,57,34,15,21,11,6,2,19,60,28.3%,18.3%
5917,8,205,182,387,75,66,44,20,18,16,10,1,27,53,49.1%,30.2%
5917,1,191,141,332,75,72,43,18,20,6,8,1,15,41,34.1%,14.6%
5918,5,233,138,371,111,73,37,15,14,11,8,2,21,49,38.8%,22.4%
5918,18,187,191,378,86,66,35,14,15,10,4,6,20,45,31.1%,22.2%
5919,2,207,121,328,98,70,28,24,18,14,8,3,25,45,48.9%,31.1%
5919,3,207,159,366,99,50,43,18,24,11,8,3,22,57,33.3%,19.3%
5920,20,177,153,330,100,38,30,23,21,7,9,0,16,34,47.1%,20.6%
5920,15,220,158,378,109,40,37,21,23,19,9,3,31,55,50.9%,34.5%
5921,12,241,134,375,111,61,54,14,13,14,8,5,27,55,40.0%,25.5%
5921,19,189,147,336,92,67,32,13,14,8,9,1,18,47,36.2%,17.0%
5922,8,218,188,406,90,58,52,15,15,17,10,3,30,51,52.9%,33.3%
5922,13,190,157,347,84,71,50,15,15,9,10,1,20,40,47.5%,22.5%
5923,18,221,163,384,91,59,45,23,14,7,15,1,23,44,50.0%,15.9%
5923,10,213,160,373,68,68,32,14,23,12,8,4,24,52,38.5%,23.1%
5924,14,219,149,368,111,80,31,31,13,12,9,0,21,47,44.7%,25.5%
5924,16,193,163,356,69,63,50,14,31,11,10,3,24,46,45.7%,23.9%
5925,9,167,190,357,92,46,34,12,20,9,8,1,18,52,32.7%,17.3%
5925,11,229,149,378,98,61,49,20,12,25,15,3,43,63,63.5%,39.7%
5926,7,202,122,324,97,69,34,30,19,15,7,2,24,51,43.1%,29.4%
5926,1,204,161,365,78,46,41,19,30,18,11,3,32,55,52.7%,32.7%
5927,4,239,202,441,117,68,55,27,10,19,9,3,31,55,50.9%,34.5%
5927,5,180,176,356,81,80,31,10,27,10,4,2,16,44,31.8%,22.7%
5928,12,207,111,318,92,53,26,26,20,11,8,2,21,46,41.3%,23.9%
5928,14,208,145,353,101,51,31,20,26,11,13,3,27,54,44.4%,20.4%
5929,10,210,192,402,95,50,39,16,16,19,11,2,32,66,45.5%,28.8%
5929,7,221,162,383,104,38,36,16,16,8,7,1,16,38,39.5%,21.1%
5930,19,186,79,265,36,81,37,19,19,7,2,3,12,39,23.1%,17.9%
5930,18,221,115,336,50,79,64,19,19,7,10,4,21,72,23.6%,9.7%
5931,3,231,212,443,90,57,24,21,13,11,8,3,22,60,31.7%,18.3%
5931,4,212,123,335,110,60,45,13,21,11,7,1,19,54,33.3%,20.4%
5932,5,183,135,318,87,57,41,13,21,8,6,2,16,43,32.6%,18.6%
5932,9,223,207,430,109,57,33,21,13,18,11,4,33,58,50.0%,31.0%
5933,11,200,102,302,41,82,53,28,17,9,10,5,24,51,37.3%,17.6%
5933,2,226,140,366,52,84,34,17,28,10,17,2,29,62,43.5%,16.1%
5934,15,235,173,408,105,81,40,22,14,17,9,0,26,66,39.4%,25.8%
5934,1,175,173,348,50,68,54,14,22,8,10,3,21,57,31.6%,14.0%
5935,13,182,163,345,92,58,44,17,13,3,14,2,19,45,37.8%,6.7%
5935,20,245,154,399,133,63,28,13,17,15,8,0,23,42,54.8%,35.7%
5936,16,213,198,411,91,59,49,23,16,17,5,3,25,52,42.3%,32.7%
5936,8,209,164,373,99,62,35,16,23,13,11,2,26,38,63.2%,34.2%
5937,18,224,174,398,112,55,44,15,18,20,16,4,40,67,53.7%,29.9%
5937,12,194,100,294,81,57,29,18,15,5,7,0,12,37,32.4%,13.5%
5938,15,218,150,368,83,49,39,10,15,14,16,1,31,55,54.5%,25.5%
5938,11,186,113,299,77,63,43,15,10,13,13,3,29,57,45.6%,22.8%
5939,3,224,140,364,114,78,54,20,10,16,9,3,28,57,43.9%,28.1%
5939,19,186,135,321,82,62,26,10,20,13,10,1,24,47,48.9%,27.7%
5940,20,206,171,377,69,88,50,19,16,9,11,2,22,46,43.5%,19.6%
5940,5,181,142,323,58,77,43,16,19,11,5,4,20,58,27.6%,19.0%
5941,4,208,134,342,102,75,39,28,16,18,10,1,29,53,52.8%,34.0%
5941,13,173,193,366,68,53,46,16,28,8,4,1,13,31,38.7%,25.8%
5942,8,208,158,366,102,60,47,15,14,14,9,1,24,47,48.9%,29.8%
5942,14,199,234,433,97,45,30,14,15,11,2,3,16,45,28.9%,24.4%
5943,9,170,214,384,91,53,31,12,12,6,7,5,18,43,30.2%,14.0%
5943,16,213,145,358,102,67,41,12,12,15,15,1,31,53,56.6%,28.3%
5944,1,207,176,383,106,60,23,17,13,9,9,4,22,46,39.1%,19.6%
5944,10,206,185,391,94,75,54,15,17,20,9,1,30,55,52.7%,36.4%
5945,2,222,191,413,118,47,38,23,14,15,6,2,23,51,41.2%,29.4%
5945,7,186,122,308,88,62,41,14,23,10,9,3,22,46,41.3%,21.7%
5946,1,207,171,378,88,47,48,16,12,15,12,7,34,67,40.3%,22.4%
5946,20,206,147,353,99,63,38,12,16,18,7,0,25,44,56.8%,40.9%
5947,12,205,130,335,102,56,38,13,11,14,5,1,20,50,38.0%,28.0%
5947,3,217,139,356,115,51,41,11,13,13,7,5,25,59,33.9%,22.0%
5948,5,169,115,284,66,56,33,19,14,8,7,1,16,41,36.6%,19.5%
5948,8,244,211,455,132,60,36,14,19,18,11,2,31,52,55.8%,34.6%
5949,19,193,165,358,84,53,27,14,14,15,7,2,24,46,47.8%,32.6%
5949,4,197,136,333,92,51,57,14,14,23,9,4,36,58,55.2%,39.7%
5950,14,199,184,383,94,64,23,15,11,21,14,3,38,58,60.3%,36.2%
5950,9,155,175,330,72,45,52,11,15,12,7,2,21,35,54.3%,34.3%
5951,10,214,174,388,83,88,42,27,20,9,8,3,20,54,31.5%,16.7%
5951,2,212,170,382,73,57,60,21,27,10,8,0,18,54,33.3%,18.5%
5952,15,188,116,304,80,70,42,20,26,19,8,1,28,43,62.8%,44.2%
5952,13,194,168,362,89,54,36,26,20,14,8,1,23,44,50.0%,31.8%
5953,11,228,165,393,107,40,50,22,13,22,6,3,31,56,50.0%,39.3%
5953,7,194,149,343,104,63,30,13,22,9,6,2,17,48,31.2%,18.8%
5954,16,199,160,359,96,58,57,11,14,16,7,2,25,41,56.1%,39.0%
5954,18,185,162,347,81,69,36,14,11,14,12,1,27,55,47.3%,25.5%
5955,8,227,160,387,100,81,46,14,12,15,8,6,29,56,41.1%,26.8%
5955,14,182,149,331,67,59,37,12,14,10,5,3,18,52,28.8%,19.2%
5956,10,210,183,393,75,71,32,20,12,13,13,2,28,54,48.1%,24.1%
5956,16,205,146,351,81,72,56,12,20,10,8,1,19,47,38.3%,21.3%
5957,15,234,156,390,122,57,43,12,16,14,7,2,23,59,35.6%,23.7%
5957,3,207,164,371,71,64,35,16,12,12,8,1,21,53,37.7%,22.6%
5958,18,216,143,359,100,41,40,20,26,20,10,2,32,58,51.7%,34.5%
5958,2,178,164,342,79,47,27,26,20,11,8,1,20,42,45.2%,26.2%
5959,14,173,106,279,82,59,31,20,19,13,11,3,27,52,46.2%,25.0%
5959,15,203,156,359,87,69,55,19,20,14,13,1,28,52,51.9%,26.9%
5960,16,200,132,332,81,58,59,18,21,11,16,1,28,49,55.1%,22.4%
5960,18,212,135,347,95,67,34,21,18,15,13,2,30,54,51.9%,27.8%
5961,10,202,154,356,87,61,44,14,18,19,13,9,41,69,46.4%,27.5%
5961,15,175,154,329,74,50,32,18,14,9,9,2,20,44,40.9%,20.5%
5962,8,196,173,369,85,69,51,17,21,15,6,1,22,44,47.7%,34.1%
5962,18,181,174,355,79,64,32,21,17,13,12,4,29,50,50.0%,26.0%
5963,10,167,131,298,67,57,43,18,18,11,6,2,19,44,38.6%,25.0%
5963,8,245,197,442,105,63,35,18,18,21,10,1,32,64,48.4%,32.8%
